,date,Postcode,geography code,Rural Urban,Variable: All usual residents; measures: Value,Variable: Males; measures: Value,Variable: Females; measures: Value,Variable: Lives in a household; measures: Value,Variable: Lives in a communal establishment; measures: Value,Variable: Schoolchild or full-time student aged 4 and over at their non term-time address; measures: Value,Variable: Area (Hectares); measures: Value,Variable: Density (number of persons per hectare); measures: Value,Longitude,Latitude,Population
0,2011,AL10 0,AL10 0,Total,9935,5039,4896,9855,80,60,243.62,40.8,-0.22781,51.7661,9679.0
1,2011,AL10 8,AL10 8,Total,10998,5648,5350,10833,165,122,216.76,50.7,-0.227127,51.7548,10997.0
2,2011,AL10 9,AL10 9,Total,14967,7640,7327,12219,2748,185,1563.16,9.6,-0.240164,51.7606,14715.0
3,2011,BA10 0,BA10 0,Total,3739,1820,1919,3238,501,143,4235.23,0.9,-2.44729,51.1124,3843.0
4,2011,BA11 1,BA11 1,Total,4992,2434,2558,4941,51,69,93.57,53.4,-2.32177,51.2324,5752.0
5,2011,BA11 2,BA11 2,Total,10935,5358,5577,10841,94,148,2751.34,4.0,-2.31263,51.2463,10272.0
6,2011,BA11 3,BA11 3,Total,4944,2421,2523,4836,108,66,2441.85,2.0,-2.35449,51.2401,5246.0
7,2011,BA11 4,BA11 4,Total,6285,3052,3233,6172,113,60,814.03,7.7,-2.3432,51.2265,6074.0
8,2011,BA11 5,BA11 5,Total,3424,1643,1781,3363,61,63,5742.46,0.6,-2.32212,51.219,3350.0
9,2011,BA11 6,BA11 6,Total,1874,912,962,1872,2,49,716.08,2.6,-2.28757,51.2738,1939.0
10,2011,BA12 0,BA12 0,Total,5660,2748,2912,5611,49,189,15214.68,0.4,-2.08502,51.178,5827.0
11,2011,BA12 6,BA12 6,Total,4285,2096,2189,4212,73,111,6416.43,0.7,-2.27756,51.0996,4238.0
12,2011,BA12 7,BA12 7,Total,3068,1473,1595,3023,45,112,11819.98,0.3,-2.21719,51.1801,3274.0
13,2011,BA12 8,BA12 8,Total,8989,4342,4647,8770,219,138,1279.4,7.0,-2.19278,51.2016,8752.0
14,2011,BA12 9,BA12 9,Total,6506,3140,3366,6317,189,110,893.44,7.3,-2.17358,51.2003,6453.0
15,2011,BA13 2,BA13 2,Total,1303,627,676,1303,0,17,65.18,20.0,-2.19709,51.263,1141.0
16,2011,BA13 3,BA13 3,Total,12876,6213,6663,12740,136,114,1361.43,9.5,-2.18975,51.2599,13168.0
17,2011,BA13 4,BA13 4,Total,6045,2966,3079,6036,9,154,6359.23,1.0,-2.17613,51.2663,5997.0
18,2011,BA14 0,BA14 0,Total,12465,6132,6333,12431,34,127,834.45,14.9,-2.21153,51.3086,12497.0
19,2011,BA14 6,BA14 6,Total,5938,2873,3065,5809,129,109,4435.61,1.3,-2.1686,51.3291,6058.0
20,2011,BA14 7,BA14 7,Total,15181,7368,7813,15101,80,192,1088.83,13.9,-2.19417,51.3238,14416.0
21,2011,BA14 8,BA14 8,Total,5810,2921,2889,5737,73,42,212.17,27.4,-2.20768,51.324,6097.0
22,2011,BA14 9,BA14 9,Total,8744,4254,4490,8611,133,129,1946.44,4.5,-2.22872,51.3107,8973.0
23,2011,BA15 1,BA15 1,Total,9149,4307,4842,9133,16,178,684.92,13.4,-2.25522,51.3472,8912.0
24,2011,BA15 2,BA15 2,Total,3990,1904,2086,3947,43,108,3031.98,1.3,-2.27535,51.3527,4083.0
25,2011,BA16 0,BA16 0,Total,10396,5098,5298,9464,932,142,1024.38,10.1,-2.7389,51.1256,10409.0
26,2011,BA16 9,BA16 9,Total,2645,1278,1367,2645,0,24,2059.7,1.3,-2.75957,51.1301,2602.0
27,2011,BA20 1,BA20 1,Total,2173,1123,1050,2084,89,21,78.26,27.8,-2.63389,50.9411,2647.0
28,2011,BA20 2,BA20 2,Total,8692,4253,4439,8484,208,104,474.81,18.3,-2.65215,50.9362,8593.0
29,2011,BA21 3,BA21 3,Total,15100,7355,7745,14882,218,179,831.32,18.2,-2.65524,50.951,14846.0
30,2011,BA21 4,BA21 4,Total,8900,4411,4489,8812,88,121,224.28,39.7,-2.62838,50.9487,9027.0
31,2011,BA21 5,BA21 5,Total,9619,4712,4907,9580,39,118,1193.67,8.1,-2.61458,50.9531,9441.0
32,2011,BA22 7,BA22 7,Total,3881,1909,1972,3772,109,108,6256.13,0.6,-2.55868,51.0322,3711.0
33,2011,BA22 8,BA22 8,Total,8965,4895,4070,7831,1134,194,6385.02,1.4,-2.66431,50.9738,9045.0
34,2011,BA22 9,BA22 9,Total,5320,2624,2696,5316,4,104,6006.47,0.9,-2.66622,50.9108,5346.0
35,2011,BB10 1,BB10 1,Total,8813,4503,4310,8665,148,86,330.13,26.7,-2.23698,53.8029,8387.0
36,2011,BB10 2,BB10 2,Total,10448,5104,5344,10392,56,126,299.44,34.9,-2.22041,53.81,10556.0
37,2011,BB10 3,BB10 3,Total,7988,3931,4057,7947,41,63,3459.82,2.3,-2.20988,53.7987,8236.0
38,2011,BB10 4,BB10 4,Total,10183,4952,5231,10152,31,105,2942.17,3.5,-2.21723,53.7824,10004.0
39,2011,BB11 2,BB11 2,Total,5203,2523,2680,5050,153,69,230.15,22.6,-2.24402,53.7842,5162.0
40,2011,BB11 3,BB11 3,Total,4093,1991,2102,4009,84,48,180.82,22.6,-2.23478,53.7818,4176.0
41,2011,BB11 4,BB11 4,Total,6065,2972,3093,5952,113,40,133.68,45.4,-2.25727,53.7846,6117.0
42,2011,BB11 5,BB11 5,Total,6860,3366,3494,6835,25,71,2319.97,3.0,-2.2746,53.7795,6711.0
43,2011,BB12 0,BB12 0,Total,8089,4110,3979,8075,14,88,340.79,23.7,-2.25678,53.7962,8156.0
44,2011,BB12 6,BB12 6,Total,8530,4101,4429,8427,103,70,422.97,20.2,-2.28008,53.7919,8431.0
45,2011,BB12 7,BB12 7,Total,7169,3531,3638,7129,40,97,1411.28,5.1,-2.32365,53.7983,6978.0
46,2011,BB12 8,BB12 8,Total,7891,3828,4063,7757,134,93,411.62,19.2,-2.30236,53.7999,7980.0
47,2011,BB12 9,BB12 9,Total,2934,1435,1499,2932,2,48,3126.6,0.9,-2.27143,53.8315,3075.0
48,2011,BB18 5,BB18 5,Total,7710,3843,3867,7688,22,67,2669.21,2.9,-2.18771,53.915,7765.0
49,2011,BB18 6,BB18 6,Total,9469,4643,4826,9407,62,105,1739.85,5.4,-2.1582,53.9149,9298.0
50,2011,BD10 0,BD10 0,Total,8834,4283,4551,8729,105,102,576.27,15.3,-1.71786,53.8308,8721.0
51,2011,BD10 8,BD10 8,Total,10627,5204,5423,10567,60,105,260.58,40.8,-1.734,53.8309,10252.0
52,2011,BD10 9,BD10 9,Total,6421,3118,3303,6339,82,40,127.66,50.3,-1.72649,53.8312,6721.0
53,2011,BD11 1,BD11 1,Total,5528,2735,2793,5482,46,45,458.96,12.0,-1.66368,53.7521,5500.0
54,2011,BD11 2,BD11 2,Total,5827,2783,3044,5760,67,51,558.35,10.4,-1.69234,53.748,5471.0
55,2011,BD12 0,BD12 0,Total,5308,2592,2716,5284,24,43,272.59,19.5,-1.76303,53.7562,5185.0
56,2011,BD12 7,BD12 7,Total,1901,921,980,1899,2,21,191.65,9.9,-1.74234,53.75,1958.0
57,2011,BD12 8,BD12 8,Total,4908,2407,2501,4906,2,26,308.61,15.9,-1.77066,53.7426,4802.0
58,2011,BD12 9,BD12 9,Total,4568,2209,2359,4553,15,28,291.4,15.7,-1.76364,53.7407,4876.0
59,2011,BD13 1,BD13 1,Total,3967,1934,2033,3946,21,31,483.55,8.2,-1.83982,53.7725,3944.0
60,2011,BD13 2,BD13 2,Total,7657,3736,3921,7613,44,63,419.49,18.3,-1.84673,53.7671,7630.0
61,2011,BD13 3,BD13 3,Total,6934,3388,3546,6860,74,63,1000.14,6.9,-1.84786,53.7926,6930.0
62,2011,BD13 4,BD13 4,Total,3489,1717,1772,3489,0,32,1025.49,3.4,-1.89057,53.8003,3452.0
63,2011,BD13 5,BD13 5,Total,2932,1382,1550,2932,0,56,906.03,3.2,-1.89244,53.8235,2861.0
64,2011,BD14 6,BD14 6,Total,8871,3966,4905,8291,580,102,401.56,22.1,-1.81771,53.7832,8860.0
65,2011,BD15 0,BD15 0,Total,4248,1987,2261,4187,61,76,466.63,9.1,-1.85943,53.8201,4410.0
66,2011,BD15 7,BD15 7,Total,8060,3902,4158,8029,31,39,236.53,34.1,-1.82308,53.8011,8044.0
67,2011,BD15 9,BD15 9,Total,3008,1485,1523,3008,0,24,147.37,20.4,-1.83142,53.811,2886.0
68,2011,BD16 1,BD16 1,Total,9433,4560,4873,9390,43,118,1424.23,6.6,-1.84104,53.8374,9102.0
69,2011,BD16 2,BD16 2,Total,3422,1664,1758,3422,0,54,215.49,15.9,-1.83805,53.8518,3545.0
70,2011,BD16 3,BD16 3,Total,5776,2839,2937,5776,0,127,1395.69,4.1,-1.8212,53.8576,5924.0
71,2011,BD16 4,BD16 4,Total,7172,3641,3531,7078,94,145,209.16,34.3,-1.83072,53.8516,7059.0
72,2011,BD17 5,BD17 5,Total,8187,4027,4160,8187,0,106,871.98,9.4,-1.779,53.8453,7791.0
73,2011,BD17 6,BD17 6,Total,6188,2949,3239,6102,86,82,162.14,38.2,-1.76244,53.8485,6512.0
74,2011,BD17 7,BD17 7,Total,3526,1767,1759,3526,0,25,606.71,5.8,-1.76552,53.8413,3689.0
75,2011,BD18 1,BD18 1,Total,7192,3533,3659,7192,0,51,179.26,40.1,-1.75861,53.8309,7020.0
76,2011,BD18 2,BD18 2,Total,6828,3342,3486,6826,2,52,164.63,41.5,-1.76913,53.8288,7208.0
77,2011,BD18 3,BD18 3,Total,5448,2719,2729,5357,91,57,192.35,28.3,-1.78132,53.8317,5541.0
78,2011,BD18 4,BD18 4,Total,7790,3740,4050,7615,175,111,307.92,25.3,-1.79527,53.8336,7523.0
79,2011,BD19 3,BD19 3,Total,5989,2978,3011,5910,79,40,193.35,31.0,-1.71764,53.7265,5151.0
80,2011,BD19 4,BD19 4,Total,9436,4628,4808,9379,57,77,643.67,14.7,-1.69662,53.7303,9562.0
81,2011,BD19 5,BD19 5,Total,2646,1298,1348,2646,0,15,108.46,24.4,-1.71424,53.7214,2879.0
82,2011,BD19 6,BD19 6,Total,3948,1958,1990,3898,50,34,473.42,8.3,-1.74037,53.7254,4467.0
83,2011,BD20 0,BD20 0,Total,6137,2992,3145,6075,62,50,1745.31,3.5,-1.93399,53.9089,5859.0
84,2011,BD20 5,BD20 5,Total,7284,3562,3722,7238,46,88,1507.23,4.8,-1.87517,53.876,7542.0
85,2011,BD20 6,BD20 6,Total,7399,3593,3806,7085,314,101,1004.98,7.4,-1.9323,53.8841,7748.0
86,2011,BD20 7,BD20 7,Total,4908,2332,2576,4781,127,83,1104.85,4.4,-1.9843,53.8935,4871.0
87,2011,BD20 8,BD20 8,Total,5509,2619,2890,5361,148,86,2102.7,2.6,-2.00563,53.9034,5505.0
88,2011,BD20 9,BD20 9,Total,4078,1922,2156,3938,140,81,2452.48,1.7,-1.96364,53.9196,4275.0
89,2011,BD21 1,BD21 1,Total,6041,2924,3117,6022,19,16,102.26,59.1,-1.91629,53.8605,5656.0
90,2011,BD21 2,BD21 2,Total,7158,3596,3562,7147,11,43,101.06,70.8,-1.91679,53.8684,6931.0
91,2011,BD21 3,BD21 3,Total,3931,2000,1931,3928,3,14,59.33,66.3,-1.90627,53.8697,4073.0
92,2011,BD21 4,BD21 4,Total,7373,3691,3682,7341,32,49,606.21,12.2,-1.8945,53.8669,6723.0
93,2011,BD21 5,BD21 5,Total,2630,1326,1304,2630,0,11,257.79,10.2,-1.91154,53.8555,3253.0
94,2011,BD22 0,BD22 0,Total,4465,2255,2210,4454,11,82,5816.58,0.8,-1.99861,53.8634,4407.0
95,2011,BD22 6,BD22 6,Total,7683,3665,4018,7642,41,66,276.37,27.8,-1.92888,53.8645,7972.0
96,2011,BD22 7,BD22 7,Total,9056,4373,4683,9036,20,87,362.6,25.0,-1.93955,53.8492,8829.0
97,2011,BD22 8,BD22 8,Total,4270,2092,2178,4193,77,36,205.58,20.8,-1.94738,53.8327,4230.0
98,2011,BD22 9,BD22 9,Total,4375,2118,2257,4375,0,62,1874.49,2.3,-1.9437,53.8234,4453.0
99,2011,BD23 1,BD23 1,Total,5900,2845,3055,5890,10,132,273.78,21.6,-2.02163,53.9619,5778.0
100,2011,BD23 2,BD23 2,Total,8348,3987,4361,8299,49,87,1106.67,7.5,-2.01555,53.9561,8563.0
101,2011,BD23 3,BD23 3,Total,4100,1969,2131,3991,109,71,10610.57,0.4,-2.09398,53.9637,4218.0
102,2011,BD23 4,BD23 4,Total,3569,1772,1797,3532,37,85,18042.36,0.2,-2.21509,54.0113,3631.0
103,2011,BD23 5,BD23 5,Total,3485,1654,1831,3376,109,76,26528.38,0.1,-2.02852,54.0881,3360.0
104,2011,BD23 6,BD23 6,Total,3927,1908,2019,3846,81,106,17915.21,0.2,-1.96928,53.992,3965.0
105,2011,BD24 0,BD24 0,Total,2003,1003,1000,1804,199,58,10291.15,0.2,-2.2976,54.0865,2039.0
106,2011,BD24 9,BD24 9,Total,3128,1497,1631,3071,57,58,4348.27,0.7,-2.27135,54.072,3141.0
107,2011,BH10 4,BH10 4,Total,4123,1998,2125,4073,50,39,114.26,36.1,-1.89826,50.7499,4594.0
108,2011,BH10 5,BH10 5,Total,7037,3437,3600,7031,6,50,158.47,44.4,-1.89573,50.7579,6879.0
109,2011,BH10 6,BH10 6,Total,5043,2409,2634,4972,71,55,137.41,36.7,-1.88643,50.7614,4825.0
110,2011,BH10 7,BH10 7,Total,3859,1909,1950,3859,0,33,222.46,17.3,-1.89128,50.7681,3770.0
111,2011,BH11 8,BH11 8,Total,9887,4778,5109,9883,4,56,277.16,35.7,-1.91631,50.7559,9819.0
112,2011,BH11 9,BH11 9,Total,10023,4890,5133,9998,25,64,428.87,23.4,-1.92226,50.7667,9964.0
113,2011,BH12 1,BH12 1,Total,6253,3117,3136,6219,34,61,199.54,31.3,-1.91294,50.7307,6047.0
114,2011,BH12 2,BH12 2,Total,7955,3944,4011,7949,6,69,130.48,61.0,-1.93103,50.7333,7408.0
115,2011,BH12 3,BH12 3,Total,8011,3952,4059,8001,10,59,140.92,56.8,-1.94115,50.7373,8068.0
116,2011,BH12 4,BH12 4,Total,8709,4223,4486,8591,118,59,328.31,26.5,-1.93126,50.7431,9083.0
117,2011,BH12 5,BH12 5,Total,4343,2153,2190,4034,309,39,152.49,28.5,-1.91245,50.7449,4360.0
118,2011,BH13 6,BH13 6,Total,4570,2154,2416,4293,277,67,193.82,23.6,-1.91024,50.718,4440.0
119,2011,BH13 7,BH13 7,Total,3751,1891,1860,3646,105,92,312.86,12.0,-1.92453,50.7046,3806.0
120,2011,BH14 0,BH14 0,Total,7000,3424,3576,6856,144,53,157.42,44.5,-1.95188,50.7271,7274.0
121,2011,BH14 8,BH14 8,Total,9262,4528,4734,9181,81,133,341.86,27.1,-1.94679,50.717,9179.0
122,2011,BH14 9,BH14 9,Total,7170,3583,3587,7065,105,126,186.61,38.4,-1.93499,50.7236,7332.0
123,2011,BH15 1,BH15 1,Total,6176,2973,3203,5735,441,44,162.25,38.1,-1.98301,50.7152,6118.0
124,2011,BH15 2,BH15 2,Total,6073,2937,3136,5947,126,48,150.75,40.3,-1.97573,50.722,6807.0
125,2011,BH15 3,BH15 3,Total,11277,5425,5852,11221,56,147,339.63,33.2,-1.9745,50.7323,10584.0
126,2011,BH15 4,BH15 4,Total,9526,4760,4766,9420,106,64,371.25,25.7,-2.00872,50.7175,9703.0
127,2011,BH16 5,BH16 5,Total,10947,5293,5654,10947,0,93,558.32,19.6,-2.02766,50.7348,10770.0
128,2011,BH16 6,BH16 6,Total,4888,2394,2494,4838,50,119,3581.84,1.4,-2.06667,50.7431,4660.0
129,2011,BH17 7,BH17 7,Total,8904,4299,4605,8891,13,64,355.87,25.0,-1.98086,50.7441,8557.0
130,2011,BH17 8,BH17 8,Total,7525,3663,3862,7466,59,48,196.88,38.2,-1.95822,50.746,7649.0
131,2011,BH17 9,BH17 9,Total,6554,3188,3366,6554,0,101,314.76,20.8,-1.96729,50.7512,6281.0
132,2011,BH18 8,BH18 8,Total,4652,2180,2472,4555,97,106,354.43,13.1,-1.98707,50.757,4931.0
133,2011,BH18 9,BH18 9,Total,6476,3149,3327,6476,0,140,304.44,21.3,-1.99974,50.7589,6930.0
134,2011,BH19 1,BH19 1,Total,4077,1941,2136,3931,146,49,606.48,6.7,-1.96249,50.6142,4183.0
135,2011,BH19 2,BH19 2,Total,5524,2680,2844,5487,37,106,514.91,10.7,-1.9643,50.6067,5357.0
136,2011,BH19 3,BH19 3,Total,1916,950,966,1872,44,45,4055.76,0.5,-1.99762,50.6165,1776.0
137,2011,BH20 4,BH20 4,Total,5496,2563,2933,5461,35,80,635.37,8.7,-2.11319,50.6903,5459.0
138,2011,BH20 5,BH20 5,Total,3940,1971,1969,3903,37,82,12733.44,0.3,-2.12183,50.6454,4152.0
139,2011,BH20 6,BH20 6,Total,5953,3081,2872,5656,297,90,4190.42,1.4,-2.21522,50.6882,5905.0
140,2011,BH20 7,BH20 7,Total,4565,2277,2288,4557,8,67,8277.62,0.6,-2.15446,50.7286,4618.0
141,2011,BH21 1,BH21 1,Total,10432,4891,5541,10276,156,167,677.14,15.4,-1.98191,50.7961,10056.0
142,2011,BH21 2,BH21 2,Total,9008,4353,4655,8964,44,163,825.46,10.9,-1.95956,50.8032,9165.0
143,2011,BH21 3,BH21 3,Total,10677,5247,5430,10277,400,176,2177.37,4.9,-2.01059,50.7751,10937.0
144,2011,BH21 4,BH21 4,Total,2220,1117,1103,2220,0,49,2954.47,0.8,-2.02325,50.8092,2678.0
145,2011,BH21 5,BH21 5,Total,2407,1188,1219,2355,52,69,9390.32,0.3,-1.97846,50.8899,2413.0
146,2011,BH21 6,BH21 6,Total,1492,692,800,1428,64,19,424.96,3.5,-1.88379,50.8663,1697.0
147,2011,BH21 7,BH21 7,Total,3813,1846,1967,3777,36,85,5203.38,0.7,-1.93869,50.8215,3178.0
148,2011,BH21 8,BH21 8,Total,522,272,250,522,0,6,1048.8,0.5,-1.92554,50.8786,524.0
149,2011,BH22 0,BH22 0,Total,7561,3563,3998,7414,147,52,853.75,8.9,-1.88233,50.8219,7505.0
150,2011,BH22 8,BH22 8,Total,10856,5262,5594,10746,110,131,962.63,11.3,-1.88507,50.7951,10570.0
151,2011,BH22 9,BH22 9,Total,8374,3894,4480,8223,151,80,586.0,14.3,-1.89593,50.806,8716.0
152,2011,BH23 1,BH23 1,Total,5592,2659,2933,5556,36,60,220.9,25.3,-1.7783,50.7349,5462.0
153,2011,BH23 2,BH23 2,Total,12055,5870,6185,11909,146,113,633.85,19.0,-1.7938,50.7454,11991.0
154,2011,BH23 3,BH23 3,Total,8891,4320,4571,8860,31,61,296.81,30.0,-1.75506,50.7361,9210.0
155,2011,BH23 4,BH23 4,Total,9687,4562,5125,9568,119,95,482.13,20.1,-1.73376,50.7395,9398.0
156,2011,BH23 5,BH23 5,Total,6849,3180,3669,6773,76,76,300.9,22.8,-1.70603,50.7439,6955.0
157,2011,BH23 6,BH23 6,Total,501,270,231,478,23,3,2235.47,0.2,-1.82371,50.7727,553.0
158,2011,BH23 7,BH23 7,Total,4485,2167,2318,4400,85,49,1186.8,3.8,-1.76195,50.7559,4829.0
159,2011,BH23 8,BH23 8,Total,4758,2280,2478,4721,37,92,3052.34,1.6,-1.73989,50.7793,4454.0
160,2011,BH24 1,BH24 1,Total,10473,4984,5489,10322,151,120,498.39,21.0,-1.78243,50.8498,10444.0
161,2011,BH24 2,BH24 2,Total,6859,3327,3532,6660,199,104,2480.7,2.8,-1.83041,50.8342,6865.0
162,2011,BH24 3,BH24 3,Total,4879,2386,2493,4788,91,106,7805.67,0.6,-1.77513,50.8521,4810.0
163,2011,BH24 4,BH24 4,Total,1384,642,742,1324,60,29,4552.97,0.3,-1.70676,50.832,1377.0
164,2011,BH25 5,BH25 5,Total,12352,5855,6497,12065,287,151,1474.9,8.4,-1.6541,50.7606,12548.0
165,2011,BH25 6,BH25 6,Total,6598,2993,3605,6413,185,38,286.76,23.0,-1.65766,50.7517,6574.0
166,2011,BH25 7,BH25 7,Total,6767,3089,3678,6574,193,62,323.17,20.9,-1.66683,50.7417,6687.0
167,2011,BH31 6,BH31 6,Total,10168,4964,5204,10168,0,114,789.24,12.9,-1.8716,50.8745,10192.0
168,2011,BH31 7,BH31 7,Total,3192,1517,1675,3173,19,32,537.96,5.9,-1.8713,50.8793,3118.0
169,2011,BN10 7,BN10 7,Total,9126,4445,4681,9050,76,51,451.16,20.2,-0.00672617,50.7981,9339.0
170,2011,BN10 8,BN10 8,Total,9453,4582,4871,9358,95,43,413.95,22.8,0.00909782,50.7937,9229.0
171,2011,BN11 1,BN11 1,Total,4628,2287,2341,4526,102,52,66.18,69.9,-0.372887,50.8144,4729.0
172,2011,BN11 2,BN11 2,Total,9066,4353,4713,8798,268,71,202.73,44.7,-0.356678,50.8161,9031.0
173,2011,BN11 3,BN11 3,Total,4200,2144,2056,4085,115,23,59.9,70.1,-0.377318,50.8103,4420.0
174,2011,BN11 4,BN11 4,Total,8956,4191,4765,8037,919,80,105.9,84.6,-0.384065,50.8146,8370.0
175,2011,BN11 5,BN11 5,Total,6428,3044,3384,6325,103,80,124.66,51.6,-0.394246,50.8123,6220.0
176,2011,BN12 4,BN12 4,Total,7807,3656,4151,7760,47,99,252.24,31.0,-0.416403,50.812,8433.0
177,2011,BN12 5,BN12 5,Total,4415,2001,2414,4343,72,41,257.98,17.1,-0.442973,50.8111,4478.0
178,2011,BN12 6,BN12 6,Total,7905,3764,4141,7905,0,54,378.6,20.9,-0.426123,50.8201,7506.0
179,2011,BN13 1,BN13 1,Total,8137,3964,4173,8118,19,105,153.75,52.9,-0.394732,50.8223,8372.0
180,2011,BN13 2,BN13 2,Total,10512,5052,5460,10455,57,73,209.52,50.2,-0.403504,50.8315,10312.0
181,2011,BN13 3,BN13 3,Total,8887,4297,4590,8774,113,104,1987.85,4.5,-0.418317,50.8358,8884.0
182,2011,BN14 0,BN14 0,Total,5739,2741,2998,5739,0,67,1869.82,3.1,-0.398171,50.854,5647.0
183,2011,BN14 7,BN14 7,Total,10779,5207,5572,10678,101,133,176.48,61.1,-0.383118,50.8227,11109.0
184,2011,BN14 8,BN14 8,Total,6774,3300,3474,6761,13,60,171.26,39.6,-0.366328,50.8223,6772.0
185,2011,BN14 9,BN14 9,Total,7444,3638,3806,7399,45,109,588.57,12.6,-0.375513,50.83,7479.0
186,2011,BN15 0,BN15 0,Total,8486,4257,4229,8165,321,103,1712.34,5.0,-0.329536,50.8367,8500.0
187,2011,BN15 8,BN15 8,Total,7801,3684,4117,7672,129,35,281.35,27.7,-0.320134,50.8241,7616.0
188,2011,BN15 9,BN15 9,Total,11084,5269,5815,11070,14,80,454.93,24.4,-0.326595,50.8306,11184.0
189,2011,BN16 1,BN16 1,Total,6626,3106,3520,6499,127,73,437.15,15.2,-0.481487,50.8117,6830.0
190,2011,BN16 2,BN16 2,Total,6920,3206,3714,6835,85,64,256.48,27.0,-0.507188,50.8079,6805.0
191,2011,BN16 3,BN16 3,Total,8060,3588,4472,7891,169,61,180.03,44.8,-0.504842,50.8153,7986.0
192,2011,BN16 4,BN16 4,Total,6728,3200,3528,6716,12,71,1658.44,4.1,-0.48444,50.8271,6510.0
193,2011,BN17 5,BN17 5,Total,6494,3247,3247,6243,251,46,850.97,7.6,-0.541866,50.8088,6251.0
194,2011,BN17 6,BN17 6,Total,13671,6513,7158,13501,170,122,416.57,32.8,-0.527038,50.8157,13547.0
195,2011,BN17 7,BN17 7,Total,8127,3964,4163,8099,28,53,368.0,22.1,-0.544488,50.8209,8744.0
196,2011,BN18 0,BN18 0,Total,8600,4350,4250,7963,637,114,5291.89,1.6,-0.606286,50.838,8477.0
197,2011,BN18 9,BN18 9,Total,4868,2330,2538,4813,55,73,5327.52,0.9,-0.549819,50.8598,4755.0
198,2011,BN20 0,BN20 0,Total,1620,761,859,1601,19,23,860.38,1.9,0.215575,50.7629,1629.0
199,2011,BN20 7,BN20 7,Total,5862,2640,3222,5112,750,72,1156.73,5.1,0.271054,50.7598,6145.0
200,2011,BN20 8,BN20 8,Total,8331,3910,4421,8225,106,115,836.58,10.0,0.256841,50.7763,8517.0
201,2011,BN20 9,BN20 9,Total,5138,2428,2710,5056,82,63,433.4,11.9,0.250835,50.7991,5110.0
202,2011,BN21 1,BN21 1,Total,6943,3236,3707,6825,118,98,167.97,41.3,0.267138,50.7743,7110.0
203,2011,BN21 2,BN21 2,Total,9050,4301,4749,8492,558,115,327.07,27.7,0.271473,50.779,8430.0
204,2011,BN21 3,BN21 3,Total,5506,2766,2740,5325,181,37,66.23,83.1,0.285363,50.7697,5465.0
205,2011,BN21 4,BN21 4,Total,4276,2167,2109,3890,386,28,60.54,70.6,0.269907,50.7677,3783.0
206,2011,BN22 0,BN22 0,Total,9479,4496,4983,9479,0,66,298.4,31.8,0.263219,50.8011,9626.0
207,2011,BN22 7,BN22 7,Total,4774,2321,2453,4732,42,34,87.38,54.6,0.300513,50.7775,5408.0
208,2011,BN22 8,BN22 8,Total,10355,5012,5343,10316,39,75,376.2,27.5,0.291722,50.7776,10201.0
209,2011,BN22 9,BN22 9,Total,7638,3596,4042,7497,141,50,244.3,31.3,0.278594,50.7973,7591.0
210,2011,BN23 5,BN23 5,Total,6273,3156,3117,6273,0,54,116.86,53.7,0.327577,50.7961,6332.0
211,2011,BN23 6,BN23 6,Total,6715,3191,3524,6687,28,48,184.26,36.4,0.313944,50.7908,6423.0
212,2011,BN23 7,BN23 7,Total,7246,3418,3828,7238,8,38,215.66,33.6,0.311425,50.8007,7591.0
213,2011,BN23 8,BN23 8,Total,8068,3888,4180,8055,13,92,200.05,40.3,0.29949,50.8094,7897.0
214,2011,BN24 5,BN24 5,Total,6255,3016,3239,6233,22,68,2918.43,2.1,0.306698,50.8182,6041.0
215,2011,BN24 6,BN24 6,Total,3036,1432,1604,3022,14,19,618.92,4.9,0.354135,50.8143,3114.0
216,2011,BN25 1,BN25 1,Total,4666,2232,2434,4510,156,38,197.73,23.6,0.103534,50.7714,4394.0
217,2011,BN25 2,BN25 2,Total,7255,3505,3750,6999,256,79,563.16,12.9,0.0937509,50.7805,7322.0
218,2011,BN25 3,BN25 3,Total,8838,4228,4610,8799,39,71,616.69,14.3,0.117365,50.7792,8715.0
219,2011,BN25 4,BN25 4,Total,2812,1301,1511,2799,13,34,348.95,8.1,0.122259,50.7718,3239.0
220,2011,BN26 5,BN26 5,Total,6296,2942,3354,6142,154,74,5238.94,1.2,0.21489,50.8143,6015.0
221,2011,BN26 6,BN26 6,Total,5130,2428,2702,5063,67,46,3459.39,1.5,0.232682,50.8277,5437.0
222,2011,BN27 1,BN27 1,Total,6219,2996,3223,6160,59,74,1610.85,3.9,0.267089,50.8715,6168.0
223,2011,BN27 2,BN27 2,Total,5172,2408,2764,5127,45,37,882.22,5.9,0.264658,50.8596,5338.0
224,2011,BN27 3,BN27 3,Total,10992,5238,5754,10572,420,120,1730.86,6.4,0.235892,50.8664,11053.0
225,2011,BN27 4,BN27 4,Total,4459,2138,2321,4259,200,81,4921.16,0.9,0.292066,50.8881,4673.0
226,2011,BN41 1,BN41 1,Total,6557,3174,3383,6526,31,52,150.67,43.5,-0.213279,50.8338,6466.0
227,2011,BN41 2,BN41 2,Total,14358,6939,7419,14254,104,117,693.71,20.7,-0.218839,50.8452,14366.0
228,2011,BN42 4,BN42 4,Total,9991,4827,5164,9920,71,86,701.77,14.2,-0.232049,50.8367,10201.0
229,2011,BN43 5,BN43 5,Total,11302,5491,5811,11240,62,139,674.34,16.8,-0.27383,50.8344,11432.0
230,2011,BN43 6,BN43 6,Total,11190,5343,5847,11029,161,98,310.02,36.1,-0.258638,50.8376,11006.0
231,2011,BN44 3,BN44 3,Total,10125,4782,5343,9972,153,192,4913.51,2.1,-0.318868,50.8929,10188.0
232,2011,BN45 7,BN45 7,Total,669,343,326,669,0,8,2247.3,0.3,-0.183189,50.8884,580.0
233,2011,BS10 5,BS10 5,Total,9500,4564,4936,9415,85,63,173.13,54.9,-2.59891,51.4976,9451.0
234,2011,BS10 6,BS10 6,Total,10223,4898,5325,10050,173,68,284.71,35.9,-2.60644,51.5069,10217.0
235,2011,BS10 7,BS10 7,Total,7882,3745,4137,7856,26,45,807.38,9.8,-2.62678,51.511,8208.0
236,2011,BS11 0,BS11 0,Total,9574,4598,4976,9528,46,46,1144.6,8.4,-2.66573,51.5004,9766.0
237,2011,BS11 9,BS11 9,Total,7780,3805,3975,7708,72,53,699.81,11.1,-2.68818,51.4959,7664.0
238,2011,BS13 0,BS13 0,Total,7542,3549,3993,7531,11,22,231.83,32.5,-2.59695,51.4058,7483.0
239,2011,BS13 7,BS13 7,Total,8316,4067,4249,8265,51,43,319.81,26.0,-2.61285,51.4206,8393.0
240,2011,BS13 8,BS13 8,Total,7339,3415,3924,7332,7,30,159.69,46.0,-2.62537,51.4123,7591.0
241,2011,BS13 9,BS13 9,Total,6388,3038,3350,6320,68,16,145.26,44.0,-2.61154,51.4086,6107.0
242,2011,BS14 0,BS14 0,Total,8866,4337,4529,8714,152,39,585.59,15.1,-2.57263,51.4086,9340.0
243,2011,BS14 8,BS14 8,Total,7765,3701,4064,7672,93,34,228.8,33.9,-2.54645,51.4145,8057.0
244,2011,BS14 9,BS14 9,Total,11524,5623,5901,11481,43,84,254.23,45.3,-2.56549,51.4176,11259.0
245,2011,BS15 1,BS15 1,Total,11936,5852,6084,11670,266,57,184.56,64.7,-2.51433,51.466,11558.0
246,2011,BS15 3,BS15 3,Total,8812,4310,4502,8750,62,85,317.02,27.8,-2.51494,51.4465,8742.0
247,2011,BS15 4,BS15 4,Total,11104,5371,5733,11082,22,57,246.01,45.1,-2.49492,51.4665,11957.0
248,2011,BS15 8,BS15 8,Total,7373,3634,3739,7324,49,41,145.58,50.6,-2.51215,51.4585,7075.0
249,2011,BS15 9,BS15 9,Total,8102,4022,4080,7987,115,39,183.42,44.2,-2.49832,51.4568,8066.0
250,2011,BS16 1,BS16 1,Total,12172,6134,6038,9669,2503,211,1289.78,9.4,-2.53772,51.4929,11975.0
251,2011,BS16 2,BS16 2,Total,9075,4383,4692,8925,150,87,245.15,37.0,-2.52688,51.4846,8959.0
252,2011,BS16 3,BS16 3,Total,6854,3458,3396,6810,44,48,124.15,55.2,-2.5314,51.4762,7208.0
253,2011,BS16 4,BS16 4,Total,9181,4454,4727,9145,36,44,146.43,62.7,-2.51347,51.4763,9424.0
254,2011,BS16 5,BS16 5,Total,9998,4870,5128,9870,128,82,177.81,56.2,-2.50857,51.483,10053.0
255,2011,BS16 6,BS16 6,Total,10598,5184,5414,10575,23,131,259.47,40.8,-2.50166,51.4947,10580.0
256,2011,BS16 7,BS16 7,Total,7880,3942,3938,7871,9,127,287.79,27.4,-2.48198,51.4924,8090.0
257,2011,BS16 9,BS16 9,Total,10150,5104,5046,10026,124,90,1134.3,8.9,-2.47428,51.4836,9444.0
258,2011,BS20 0,BS20 0,Total,4828,2410,2418,4791,37,54,777.6,6.2,-2.68947,51.4787,4858.0
259,2011,BS20 6,BS20 6,Total,7966,3879,4087,7934,32,96,407.69,19.5,-2.77283,51.4807,8253.0
260,2011,BS20 7,BS20 7,Total,11362,5655,5707,11309,53,119,1896.08,6.0,-2.75547,51.4836,11130.0
261,2011,BS20 8,BS20 8,Total,5847,2845,3002,5807,40,130,606.16,9.6,-2.79077,51.4777,5801.0
262,2011,BS21 5,BS21 5,Total,4861,2384,2477,4858,3,71,222.75,21.8,-2.85403,51.4294,4757.0
263,2011,BS21 6,BS21 6,Total,8926,4336,4590,8811,115,110,2915.86,3.1,-2.8456,51.433,8980.0
264,2011,BS21 7,BS21 7,Total,9496,4495,5001,9002,494,131,808.36,11.7,-2.85534,51.4411,9571.0
265,2011,BS22 6,BS22 6,Total,7979,3758,4221,7970,9,65,171.78,46.4,-2.92278,51.3594,7516.0
266,2011,BS22 7,BS22 7,Total,10339,5085,5254,10339,0,118,849.19,12.2,-2.91452,51.3653,10456.0
267,2011,BS22 8,BS22 8,Total,10599,5163,5436,10599,0,110,249.29,42.5,-2.94167,51.3519,10796.0
268,2011,BS22 9,BS22 9,Total,8525,4169,4356,8418,107,94,1163.93,7.3,-2.94127,51.3627,8933.0
269,2011,BS23 1,BS23 1,Total,4940,2485,2455,4437,503,26,99.22,49.8,-2.97461,51.346,5039.0
270,2011,BS23 2,BS23 2,Total,9195,4490,4705,8568,627,72,323.4,28.4,-2.97381,51.3525,9276.0
271,2011,BS23 3,BS23 3,Total,12214,5988,6226,12076,138,66,293.64,41.6,-2.96282,51.3418,11740.0
272,2011,BS23 4,BS23 4,Total,7647,3631,4016,7275,372,85,370.5,20.6,-2.9748,51.3304,8018.0
273,2011,BS24 0,BS24 0,Total,2039,981,1058,2014,25,45,1980.72,1.0,-2.94872,51.3002,2109.0
274,2011,BS24 6,BS24 6,Total,359,180,179,359,0,11,778.79,0.5,-2.87311,51.3408,617.0
275,2011,BS24 7,BS24 7,Total,8306,4019,4287,8242,64,50,485.14,17.1,-2.91599,51.3469,8063.0
276,2011,BS24 8,BS24 8,Total,2166,1055,1111,2166,0,19,569.23,3.8,-2.93088,51.335,2485.0
277,2011,BS24 9,BS24 9,Total,5971,2827,3144,5953,18,57,491.47,12.1,-2.95011,51.3257,5761.0
278,2011,BS25 1,BS25 1,Total,4616,2242,2374,4398,218,86,1735.65,2.7,-2.8285,51.3158,4529.0
279,2011,BS25 5,BS25 5,Total,1616,753,863,1506,110,42,1175.47,1.4,-2.82074,51.3327,1859.0
280,2011,BS26 2,BS26 2,Total,5127,2528,2599,5066,61,124,5388.51,1.0,-2.8506,51.2804,4934.0
281,2011,BS27 3,BS27 3,Total,7081,3375,3706,6969,112,140,4590.87,1.5,-2.77212,51.2723,6996.0
282,2011,BS28 4,BS28 4,Total,3318,1633,1685,3318,0,88,4165.37,0.8,-2.81513,51.2273,3339.0
283,2011,BS29 6,BS29 6,Total,2919,1410,1509,2919,0,37,1726.93,1.7,-2.87437,51.3307,2588.0
284,2011,BS30 5,BS30 5,Total,5040,2446,2594,5026,14,55,2330.0,2.2,-2.44993,51.4559,5255.0
285,2011,BS30 6,BS30 6,Total,3509,1723,1786,3462,47,67,1165.29,3.0,-2.47123,51.4339,3666.0
286,2011,BS30 7,BS30 7,Total,3666,1861,1805,3666,0,36,91.6,40.0,-2.49496,51.4469,3442.0
287,2011,BS30 8,BS30 8,Total,10295,5035,5260,10182,113,72,423.52,24.3,-2.48245,51.4499,10013.0
288,2011,BS30 9,BS30 9,Total,7850,3882,3968,7787,63,88,384.79,20.4,-2.4869,51.4416,7717.0
289,2011,BS31 1,BS31 1,Total,7446,3563,3883,7388,58,113,466.09,16.0,-2.49263,51.4094,7531.0
290,2011,BS31 2,BS31 2,Total,8481,4058,4423,8388,93,84,1436.19,5.9,-2.50608,51.4118,8347.0
291,2011,BS31 3,BS31 3,Total,4073,1995,2078,4054,19,91,556.02,7.3,-2.46223,51.4026,4077.0
292,2011,BS32 0,BS32 0,Total,7373,3755,3618,7356,17,71,173.28,42.5,-2.55323,51.5375,7484.0
293,2011,BS32 4,BS32 4,Total,4380,2118,2262,4292,88,91,3111.06,1.4,-2.56813,51.5488,4211.0
294,2011,BS32 8,BS32 8,Total,8354,4162,4192,8354,0,105,138.0,60.5,-2.55198,51.5297,7944.0
295,2011,BS32 9,BS32 9,Total,4651,2361,2290,4650,1,36,111.99,41.5,-2.55916,51.5365,4904.0
296,2011,BS34 5,BS34 5,Total,8122,4044,4078,8119,3,41,357.38,22.7,-2.58124,51.531,8176.0
297,2011,BS34 6,BS34 6,Total,6295,3097,3198,6281,14,44,156.49,40.2,-2.56107,51.5312,6243.0
298,2011,BS34 7,BS34 7,Total,7057,3608,3449,7002,55,50,321.36,22.0,-2.57042,51.5115,7164.0
299,2011,BS34 8,BS34 8,Total,8316,4209,4107,8271,45,105,407.3,20.4,-2.55199,51.5206,8325.0
300,2011,BS35 1,BS35 1,Total,6608,3207,3401,6460,148,152,3964.53,1.7,-2.52825,51.6175,6012.0
301,2011,BS35 2,BS35 2,Total,6436,3220,3216,6436,0,112,332.12,19.4,-2.51773,51.6059,6634.0
302,2011,BS35 3,BS35 3,Total,3058,1520,1538,3036,22,49,1280.21,2.4,-2.52735,51.5915,3413.0
303,2011,BS35 4,BS35 4,Total,4888,2451,2437,4879,9,54,2320.84,2.1,-2.62152,51.5728,5208.0
304,2011,BS35 5,BS35 5,Total,650,325,325,650,0,12,741.09,0.9,-2.62177,51.5391,651.0
305,2011,BS36 1,BS36 1,Total,6242,2995,3247,6161,81,84,411.82,15.2,-2.50229,51.5231,6541.0
306,2011,BS36 2,BS36 2,Total,9201,4608,4593,9144,57,123,1896.11,4.9,-2.47711,51.5281,9113.0
307,2011,BS37 4,BS37 4,Total,8102,4009,4093,8030,72,65,227.52,35.6,-2.42045,51.536,8221.0
308,2011,BS37 5,BS37 5,Total,7723,3795,3928,7702,21,74,252.73,30.6,-2.42789,51.5439,7789.0
309,2011,BS37 6,BS37 6,Total,8025,3930,4095,7949,76,109,4978.7,1.6,-2.39851,51.5364,7959.0
310,2011,BS37 7,BS37 7,Total,6952,3449,3503,6798,154,86,1399.58,5.0,-2.4192,51.5536,6666.0
311,2011,BS37 8,BS37 8,Total,6452,3186,3266,6434,18,43,541.02,11.9,-2.42518,51.5246,6574.0
312,2011,BS37 9,BS37 9,Total,807,401,406,805,2,12,1063.94,0.8,-2.45968,51.5529,871.0
313,2011,BS39 4,BS39 4,Total,2593,1269,1324,2564,29,40,3461.57,0.7,-2.54736,51.3669,2591.0
314,2011,BS39 5,BS39 5,Total,4563,2256,2307,4516,47,111,2550.13,1.8,-2.55496,51.3273,4475.0
315,2011,BS39 6,BS39 6,Total,3005,1478,1527,2937,68,46,842.07,3.6,-2.51899,51.3137,3051.0
316,2011,BS39 7,BS39 7,Total,5302,2595,2707,5203,99,48,651.23,8.1,-2.50107,51.3055,5274.0
317,2011,BS40 5,BS40 5,Total,4496,2174,2322,4486,10,88,2809.27,1.6,-2.75944,51.3562,4410.0
318,2011,BS40 6,BS40 6,Total,2249,1103,1146,2246,3,68,5888.37,0.4,-2.64914,51.3097,2112.0
319,2011,BS40 7,BS40 7,Total,1571,756,815,1571,0,44,1502.47,1.0,-2.71913,51.3297,1675.0
320,2011,BS40 8,BS40 8,Total,3833,1890,1943,3830,3,106,4182.99,0.9,-2.6393,51.3631,3479.0
321,2011,BS40 9,BS40 9,Total,637,318,319,637,0,5,155.18,4.1,-2.6914,51.3876,873.0
322,2011,BS41 8,BS41 8,Total,829,420,409,829,0,19,982.21,0.8,-2.63201,51.4018,850.0
323,2011,BS41 9,BS41 9,Total,5254,2567,2687,5224,30,102,715.07,7.3,-2.66144,51.4303,5270.0
324,2011,BS48 1,BS48 1,Total,5537,2680,2857,5431,106,111,2410.25,2.3,-2.74495,51.4349,5152.0
325,2011,BS48 2,BS48 2,Total,6848,3289,3559,6848,0,118,215.61,31.8,-2.76132,51.4313,7633.0
326,2011,BS48 3,BS48 3,Total,5537,2692,2845,5503,34,159,2810.93,2.0,-2.72969,51.4133,5462.0
327,2011,BS48 4,BS48 4,Total,5486,2692,2794,5486,0,123,885.99,6.2,-2.76701,51.4253,4946.0
328,2011,BS49 4,BS49 4,Total,8454,4162,4292,8362,92,145,1930.05,4.4,-2.81942,51.388,8412.0
329,2011,BS49 5,BS49 5,Total,3497,1602,1895,3444,53,67,1550.66,2.3,-2.80962,51.3713,3364.0
330,2011,CA10 1,CA10 1,Total,5757,2884,2873,5743,14,119,26775.79,0.2,-2.63262,54.6993,5791.0
331,2011,CA10 2,CA10 2,Total,3286,1641,1645,3194,92,56,26884.92,0.1,-2.74051,54.6185,3463.0
332,2011,CA10 3,CA10 3,Total,4580,2285,2295,4555,25,80,23606.39,0.2,-2.63132,54.5224,4674.0
333,2011,CA11 0,CA11 0,Total,4416,2210,2206,4125,291,84,28472.8,0.2,-2.86855,54.6348,4526.0
334,2011,CA11 7,CA11 7,Total,3561,1763,1798,3542,19,68,87.34,40.8,-2.75308,54.6649,3825.0
335,2011,CA11 8,CA11 8,Total,7907,3754,4153,7677,230,82,3953.55,2.0,-2.74119,54.6653,7646.0
336,2011,CA11 9,CA11 9,Total,6475,3267,3208,6432,43,114,11197.5,0.6,-2.78566,54.6959,6138.0
337,2011,CA12 4,CA12 4,Total,4758,2320,2438,4510,248,79,15557.85,0.3,-3.11997,54.6088,4889.0
338,2011,CA12 5,CA12 5,Total,3268,1623,1645,3010,258,47,13050.44,0.3,-3.14821,54.5961,3158.0
339,2011,CA13 0,CA13 0,Total,8597,4243,4354,8516,81,183,13933.75,0.6,-3.39032,54.6625,8618.0
340,2011,CA13 9,CA13 9,Total,6409,3128,3281,6333,76,128,11308.69,0.6,-3.34363,54.6582,6394.0
341,2011,CA14 1,CA14 1,Total,8434,4153,4281,8407,27,92,2819.28,3.0,-3.51623,54.6557,8775.0
342,2011,CA14 2,CA14 2,Total,5050,2564,2486,5050,0,41,172.69,29.2,-3.55444,54.6429,5037.0
343,2011,CA14 3,CA14 3,Total,8500,4093,4407,8380,120,55,233.9,36.3,-3.55139,54.6358,8778.0
344,2011,CA14 4,CA14 4,Total,6518,3243,3275,6332,186,105,7023.18,0.9,-3.51775,54.6176,6079.0
345,2011,CA14 5,CA14 5,Total,7297,3539,3758,7245,52,36,855.22,8.5,-3.55546,54.6138,7163.0
346,2011,CA15 6,CA15 6,Total,4469,2221,2248,4409,60,54,4130.53,1.1,-3.47205,54.7293,4371.0
347,2011,CA15 7,CA15 7,Total,6771,3329,3442,6727,44,74,1657.16,4.1,-3.47144,54.707,6893.0
348,2011,CA15 8,CA15 8,Total,4978,2442,2536,4927,51,29,1003.69,5.0,-3.50334,54.6991,4846.0
349,2011,CA16 6,CA16 6,Total,6175,3054,3121,6054,121,116,28510.65,0.2,-2.48521,54.574,6187.0
350,2011,CA17 4,CA17 4,Total,4873,2421,2452,4819,54,79,32419.63,0.2,-2.3505,54.4799,4827.0
351,2011,CA18 1,CA18 1,Total,328,167,161,318,10,8,2935.47,0.1,-3.39043,54.3546,324.0
352,2011,CA19 1,CA19 1,Total,1069,554,515,1049,20,20,12548.0,0.1,-3.38683,54.3872,1112.0
353,2011,CA20 1,CA20 1,Total,3355,1708,1647,3297,58,50,11383.91,0.3,-3.46336,54.41,3312.0
354,2011,CA21 2,CA21 2,Total,1017,526,491,1016,1,26,1095.08,0.9,-3.51654,54.4453,814.0
355,2011,CA22 2,CA22 2,Total,8887,4380,4507,8849,38,79,3840.21,2.3,-3.53244,54.4804,9284.0
356,2011,CA23 3,CA23 3,Total,1424,738,686,1417,7,23,9548.22,0.1,-3.49511,54.5138,1492.0
357,2011,CA24 3,CA24 3,Total,1266,664,602,1266,0,20,384.32,3.3,-3.54321,54.5146,1036.0
358,2011,CA25 5,CA25 5,Total,6183,3091,3092,6122,61,52,1120.27,5.5,-3.51961,54.5221,6091.0
359,2011,CA26 3,CA26 3,Total,3868,1903,1965,3867,1,32,2980.78,1.3,-3.4855,54.5443,3608.0
360,2011,CA27 0,CA27 0,Total,1644,854,790,1561,83,59,741.0,2.2,-3.59294,54.4909,1660.0
361,2011,CA28 6,CA28 6,Total,9888,4969,4919,9830,58,139,1098.39,9.0,-3.57509,54.5571,9799.0
362,2011,CA28 7,CA28 7,Total,2798,1464,1334,2729,69,22,113.2,24.7,-3.58607,54.5467,2988.0
363,2011,CA28 8,CA28 8,Total,8811,4309,4502,8645,166,93,993.89,8.9,-3.56568,54.5377,8785.0
364,2011,CA28 9,CA28 9,Total,7095,3500,3595,7051,44,50,992.43,7.1,-3.59046,54.5314,7277.0
365,2011,CB10 1,CB10 1,Total,4610,2251,2359,4603,7,123,4743.01,1.0,0.223818,52.0432,4733.0
366,2011,CB10 2,CB10 2,Total,8887,4489,4398,8641,246,243,9759.32,0.9,0.293792,52.0198,9055.0
367,2011,CB11 3,CB11 3,Total,9635,4712,4923,9464,171,208,4951.56,1.9,0.232349,51.9957,9194.0
368,2011,CB11 4,CB11 4,Total,8412,4152,4260,8364,48,218,7721.77,1.1,0.192932,52.0089,8639.0
369,2011,CB21 4,CB21 4,Total,8505,4141,4364,8417,88,195,8515.58,1.0,0.311833,52.1043,8495.0
370,2011,CB21 5,CB21 5,Total,5556,2738,2818,5467,89,121,6561.15,0.8,0.244457,52.1774,5430.0
371,2011,CB21 6,CB21 6,Total,1565,762,803,1565,0,44,1778.47,0.9,0.232485,52.1182,1562.0
372,2011,CB22 3,CB22 3,Total,7765,3825,3940,7726,39,119,2396.46,3.2,0.17252,52.1324,7849.0
373,2011,CB22 4,CB22 4,Total,4311,2142,2169,4310,1,116,2197.54,2.0,0.147535,52.1077,4309.0
374,2011,CB22 5,CB22 5,Total,7617,3726,3891,7602,15,172,2315.0,3.3,0.133521,52.1519,7557.0
375,2011,CB22 6,CB22 6,Total,1232,617,615,1232,0,33,711.09,1.7,0.0596631,52.1147,1218.0
376,2011,CB22 7,CB22 7,Total,3100,1528,1572,3100,0,65,2031.05,1.5,0.0777476,52.141,3119.0
377,2011,CB23 1,CB23 1,Total,2656,1317,1339,2656,0,73,2589.56,1.0,0.0428573,52.1563,2637.0
378,2011,CB23 2,CB23 2,Total,1961,970,991,1959,2,52,3170.99,0.6,-0.0442866,52.1881,1871.0
379,2011,CB23 3,CB23 3,Total,3452,1676,1776,3436,16,46,1108.09,3.1,-0.112229,52.2446,3482.0
380,2011,CB23 4,CB23 4,Total,1081,533,548,1079,2,38,3720.96,0.3,-0.0500435,52.253,1090.0
381,2011,CB23 5,CB23 5,Total,2337,1173,1164,2337,0,44,99.67,23.4,-0.0548139,52.2145,3098.0
382,2011,CB23 6,CB23 6,Total,5849,2909,2940,5849,0,46,578.94,10.1,-0.0566328,52.2198,5114.0
383,2011,CB23 7,CB23 7,Total,8509,4174,4335,8509,0,202,3333.75,2.6,0.0324771,52.2044,8550.0
384,2011,CB23 8,CB23 8,Total,5040,2523,2517,5034,6,89,2272.33,2.2,0.0271936,52.2449,5099.0
385,2011,CB24 3,CB24 3,Total,4184,2102,2082,4183,1,59,2010.02,2.1,0.0610731,52.2679,4172.0
386,2011,CB24 4,CB24 4,Total,3319,1678,1641,3319,0,58,2213.95,1.5,-0.00854795,52.2924,3289.0
387,2011,CB24 5,CB24 5,Total,6877,3402,3475,6875,2,128,3389.94,2.0,0.0468693,52.3099,6867.0
388,2011,CB24 6,CB24 6,Total,4251,2142,2109,4221,30,75,720.36,5.9,0.158103,52.2376,4195.0
389,2011,CB24 8,CB24 8,Total,6543,3181,3362,6457,86,122,3480.94,1.9,0.124127,52.287,6521.0
390,2011,CB24 9,CB24 9,Total,7866,3834,4032,7714,152,164,1305.11,6.0,0.10836,52.2503,7856.0
391,2011,CB25 0,CB25 0,Total,8216,4004,4212,8193,23,135,5824.72,1.4,0.303767,52.2652,8202.0
392,2011,CB25 9,CB25 9,Total,10048,5171,4877,9366,682,150,7115.47,1.4,0.206621,52.2511,10072.0
393,2011,CH41 0,CH41 0,Total,3637,1748,1889,3625,12,28,69.21,52.6,-3.05518,53.3973,3692.0
394,2011,CH41 1,CH41 1,Total,526,296,230,494,32,1,63.38,8.3,-3.02404,53.4004,381.0
395,2011,CH41 2,CH41 2,Total,2943,1510,1433,2875,68,10,48.52,60.7,-3.02763,53.388,2523.0
396,2011,CH41 3,CH41 3,Total,1286,625,661,1286,0,3,45.61,28.2,-3.02675,53.3961,1197.0
397,2011,CH41 4,CH41 4,Total,2994,1379,1615,2994,0,12,103.96,28.8,-3.03067,53.3942,3044.0
398,2011,CH41 5,CH41 5,Total,738,396,342,736,2,2,43.63,16.9,-3.01399,53.3926,729.0
399,2011,CH41 6,CH41 6,Total,147,88,59,147,0,0,5.39,27.3,-3.01933,53.3928,478.0
400,2011,CH41 7,CH41 7,Total,2241,1024,1217,2217,24,12,163.69,13.7,-3.06064,53.403,2194.0
401,2011,CH41 8,CH41 8,Total,2528,1233,1295,2528,0,10,119.75,21.1,-3.04446,53.4,2546.0
402,2011,CH41 9,CH41 9,Total,1627,765,862,1627,0,15,92.95,17.5,-3.01836,53.3834,1893.0
403,2011,CH42 0,CH42 0,Total,2712,1306,1406,2712,0,15,28.36,95.6,-3.02797,53.3822,2851.0
404,2011,CH42 1,CH42 1,Total,3342,1643,1699,3269,73,9,80.57,41.5,-3.00467,53.3707,3465.0
405,2011,CH42 2,CH42 2,Total,2209,1075,1134,2157,52,17,42.09,52.5,-3.00979,53.3716,2272.0
406,2011,CH42 3,CH42 3,Total,2641,1232,1409,2636,5,14,68.24,38.7,-3.01485,53.376,2063.0
407,2011,CH42 4,CH42 4,Total,3930,1917,2013,3851,79,30,75.35,52.2,-3.01501,53.3701,4267.0
408,2011,CH42 5,CH42 5,Total,3073,1447,1626,3073,0,14,43.55,70.6,-3.02027,53.3791,2844.0
409,2011,CH42 6,CH42 6,Total,4402,2067,2335,4366,36,40,80.12,54.9,-3.02616,53.3729,3960.0
410,2011,CH42 7,CH42 7,Total,2307,1139,1168,2263,44,7,26.61,86.7,-3.02845,53.38,2574.0
411,2011,CH42 8,CH42 8,Total,2521,1191,1330,2466,55,53,93.61,26.9,-3.03668,53.3731,2415.0
412,2011,CH42 9,CH42 9,Total,3919,1917,2002,3891,28,26,47.33,82.8,-3.03436,53.3788,4576.0
413,2011,CH43 0,CH43 0,Total,5411,2652,2759,5411,0,53,113.4,47.7,-3.05816,53.3709,4972.0
414,2011,CH43 1,CH43 1,Total,2750,1375,1375,2598,152,35,54.63,50.3,-3.05,53.3836,2917.0
415,2011,CH43 2,CH43 2,Total,4378,2185,2193,4357,21,50,110.19,39.7,-3.05573,53.3776,4307.0
416,2011,CH43 3,CH43 3,Total,2596,1238,1358,2596,0,23,142.27,18.2,-3.06128,53.3669,2806.0
417,2011,CH43 4,CH43 4,Total,2866,1450,1416,2681,185,19,77.77,36.9,-3.03989,53.3875,2923.0
418,2011,CH43 5,CH43 5,Total,3573,1752,1821,3568,5,45,73.37,48.7,-3.0443,53.3784,3084.0
419,2011,CH43 6,CH43 6,Total,1718,792,926,1556,162,20,56.29,30.5,-3.05649,53.3856,1576.0
420,2011,CH43 7,CH43 7,Total,5742,2655,3087,5686,56,44,170.65,33.6,-3.07284,53.3974,6547.0
421,2011,CH43 8,CH43 8,Total,1730,868,862,1709,21,23,62.46,27.7,-3.05667,53.3896,1620.0
422,2011,CH43 9,CH43 9,Total,8152,3820,4332,8078,74,65,325.47,25.0,-3.07349,53.3841,7830.0
423,2011,CH44 0,CH44 0,Total,3111,1543,1568,3069,42,22,35.11,88.6,-3.03294,53.4204,3250.0
424,2011,CH44 1,CH44 1,Total,2764,1356,1408,2733,31,24,29.46,93.8,-3.03765,53.4212,2682.0
425,2011,CH44 2,CH44 2,Total,2766,1347,1419,2754,12,31,55.96,49.4,-3.05881,53.4192,3071.0
426,2011,CH44 3,CH44 3,Total,2470,1195,1275,2446,24,24,42.06,58.7,-3.05278,53.4159,2372.0
427,2011,CH44 4,CH44 4,Total,4346,2102,2244,4346,0,22,137.28,31.7,-3.03707,53.4124,4371.0
428,2011,CH44 5,CH44 5,Total,3069,1514,1555,3004,65,23,46.42,66.1,-3.0468,53.4158,3183.0
429,2011,CH44 6,CH44 6,Total,2581,1263,1318,2581,0,10,34.44,74.9,-3.02199,53.412,2541.0
430,2011,CH44 7,CH44 7,Total,1807,859,948,1807,0,8,62.41,29.0,-3.02457,53.4091,1996.0
431,2011,CH44 8,CH44 8,Total,3180,1587,1593,3101,79,12,34.4,92.4,-3.02957,53.4182,2968.0
432,2011,CH44 9,CH44 9,Total,3820,1886,1934,3777,43,21,45.42,84.1,-3.03291,53.4137,3576.0
433,2011,CH45 0,CH45 0,Total,1675,811,864,1642,33,29,55.68,30.1,-3.05445,53.4315,1769.0
434,2011,CH45 1,CH45 1,Total,2787,1353,1434,2787,0,28,50.52,55.2,-3.03871,53.4321,3053.0
435,2011,CH45 2,CH45 2,Total,2531,1257,1274,2498,33,20,57.38,44.1,-3.04473,53.4362,2430.0
436,2011,CH45 3,CH45 3,Total,2549,1225,1324,2549,0,36,69.18,36.8,-3.06385,53.4277,2845.0
437,2011,CH45 4,CH45 4,Total,3881,1834,2047,3881,0,31,63.22,61.4,-3.0483,53.4228,3708.0
438,2011,CH45 5,CH45 5,Total,4846,2352,2494,4815,31,53,60.61,80.0,-3.04564,53.43,4647.0
439,2011,CH45 6,CH45 6,Total,2509,1217,1292,2509,0,67,41.27,60.8,-3.05663,53.4255,2514.0
440,2011,CH45 7,CH45 7,Total,3467,1651,1816,3276,191,30,45.73,75.8,-3.03791,53.4256,3771.0
441,2011,CH45 8,CH45 8,Total,4498,2177,2321,4495,3,47,224.05,20.1,-3.07016,53.4235,4107.0
442,2011,CH45 9,CH45 9,Total,2112,1061,1051,2076,36,16,32.06,65.9,-3.04812,53.4332,1951.0
443,2011,CH46 0,CH46 0,Total,3699,1801,1898,3689,10,33,82.46,44.9,-3.11221,53.3971,3917.0
444,2011,CH46 1,CH46 1,Total,2755,1299,1456,2755,0,23,130.52,21.1,-3.09748,53.411,3412.0
445,2011,CH46 2,CH46 2,Total,2699,1264,1435,2699,0,18,152.15,17.7,-3.09198,53.4157,2390.0
446,2011,CH46 3,CH46 3,Total,1835,906,929,1835,0,16,97.65,18.8,-3.10785,53.4135,1922.0
447,2011,CH46 5,CH46 5,Total,523,249,274,522,1,4,47.8,10.9,-3.12747,53.393,545.0
448,2011,CH46 6,CH46 6,Total,5372,2593,2779,5329,43,52,271.81,19.8,-3.12453,53.3999,5172.0
449,2011,CH46 7,CH46 7,Total,2665,1293,1372,2628,37,10,81.86,32.6,-3.12,53.4041,2608.0
450,2011,CH46 8,CH46 8,Total,3033,1446,1587,3033,0,15,89.48,33.9,-3.10821,53.4046,2495.0
451,2011,CH46 9,CH46 9,Total,2899,1392,1507,2896,3,12,109.42,26.5,-3.10096,53.4006,2738.0
452,2011,CH47 0,CH47 0,Total,628,302,326,616,12,14,10.2,61.6,-3.16446,53.3979,1234.0
453,2011,CH47 1,CH47 1,Total,665,309,356,607,58,19,55.26,12.0,-3.18706,53.3904,672.0
454,2011,CH47 2,CH47 2,Total,2103,1019,1084,2026,77,25,28.75,73.1,-3.17911,53.3933,2205.0
455,2011,CH47 3,CH47 3,Total,2305,1097,1208,2252,53,43,66.14,34.9,-3.17461,53.395,2152.0
456,2011,CH47 4,CH47 4,Total,933,438,495,933,0,22,140.62,6.6,-3.17866,53.3887,760.0
457,2011,CH47 5,CH47 5,Total,788,382,406,721,67,22,20.64,38.2,-3.1704,53.3991,811.0
458,2011,CH47 6,CH47 6,Total,916,426,490,916,0,23,32.81,27.9,-3.16112,53.402,768.0
459,2011,CH47 7,CH47 7,Total,1244,606,638,1244,0,18,62.64,19.9,-3.15506,53.403,1057.0
460,2011,CH47 9,CH47 9,Total,1327,617,710,1327,0,38,403.7,3.3,-3.1512,53.3961,985.0
461,2011,CH48 0,CH48 0,Total,1764,835,929,1764,0,28,61.35,28.8,-3.18381,53.3729,1308.0
462,2011,CH48 1,CH48 1,Total,899,425,474,899,0,30,271.04,3.3,-3.15311,53.3677,1201.0
463,2011,CH48 2,CH48 2,Total,1367,670,697,1330,37,45,208.84,6.5,-3.17048,53.366,1210.0
464,2011,CH48 3,CH48 3,Total,1381,621,760,1381,0,29,31.86,43.3,-3.17835,53.3689,1606.0
465,2011,CH48 4,CH48 4,Total,812,383,429,789,23,17,21.89,37.1,-3.18173,53.3758,1332.0
466,2011,CH48 5,CH48 5,Total,2694,1248,1446,2584,110,47,265.7,10.1,-3.18175,53.3777,2368.0
467,2011,CH48 6,CH48 6,Total,2089,981,1108,2086,3,37,66.48,31.4,-3.1664,53.3771,2145.0
468,2011,CH48 7,CH48 7,Total,617,315,302,617,0,17,24.57,25.1,-3.17293,53.3729,982.0
469,2011,CH48 8,CH48 8,Total,1301,651,650,1301,0,52,84.01,15.5,-3.16269,53.3708,1133.0
470,2011,CH48 9,CH48 9,Total,2282,1108,1174,2282,0,50,166.79,13.7,-3.15761,53.3749,1986.0
471,2011,CH49 0,CH49 0,Total,1747,846,901,1747,0,30,84.28,20.7,-3.0969,53.3825,1593.0
472,2011,CH49 1,CH49 1,Total,2453,1189,1264,2453,0,49,70.68,34.7,-3.11173,53.3764,2434.0
473,2011,CH49 2,CH49 2,Total,3664,1740,1924,3664,0,51,116.61,31.4,-3.11572,53.3818,3832.0
474,2011,CH49 3,CH49 3,Total,3294,1571,1723,3239,55,66,226.37,14.6,-3.12078,53.376,3207.0
475,2011,CH49 4,CH49 4,Total,5099,2350,2749,5040,59,44,130.69,39.0,-3.10803,53.3896,5310.0
476,2011,CH49 5,CH49 5,Total,1557,772,785,1471,86,17,85.28,18.3,-3.08937,53.3711,1579.0
477,2011,CH49 6,CH49 6,Total,4085,1947,2138,4028,57,89,126.02,32.4,-3.10014,53.3862,3798.0
478,2011,CH49 7,CH49 7,Total,2287,1046,1241,2287,0,10,49.9,45.8,-3.08272,53.3735,2547.0
479,2011,CH49 8,CH49 8,Total,2699,1256,1443,2699,0,13,60.27,44.8,-3.08888,53.3768,2391.0
480,2011,CH49 9,CH49 9,Total,1892,852,1040,1846,46,11,47.17,40.1,-3.09107,53.3806,2205.0
481,2011,CH60 0,CH60 0,Total,1280,591,689,1262,18,33,61.36,20.9,-3.09748,53.3259,1022.0
482,2011,CH60 1,CH60 1,Total,1892,904,988,1892,0,38,67.11,28.2,-3.07984,53.3286,1891.0
483,2011,CH60 2,CH60 2,Total,1510,746,764,1510,0,46,79.51,19.0,-3.08503,53.3269,1395.0
484,2011,CH60 3,CH60 3,Total,1018,514,504,1018,0,37,96.98,10.5,-3.08614,53.3206,1125.0
485,2011,CH60 4,CH60 4,Total,790,372,418,784,6,29,121.95,6.5,-3.10413,53.3253,926.0
486,2011,CH60 5,CH60 5,Total,1928,921,1007,1914,14,41,68.73,28.1,-3.09389,53.3297,1748.0
487,2011,CH60 6,CH60 6,Total,1267,603,664,1259,8,43,127.55,9.9,-3.10828,53.3331,1279.0
488,2011,CH60 7,CH60 7,Total,1215,550,665,1215,0,16,32.29,37.6,-3.09897,53.3319,1421.0
489,2011,CH60 8,CH60 8,Total,970,478,492,970,0,33,349.63,2.8,-3.09711,53.3204,1156.0
490,2011,CH60 9,CH60 9,Total,1214,581,633,1201,13,29,183.48,6.6,-3.11563,53.3284,1293.0
491,2011,CH61 0,CH61 0,Total,498,241,257,498,0,17,402.76,1.2,-3.12837,53.3516,525.0
492,2011,CH61 1,CH61 1,Total,1220,583,637,1204,16,31,563.74,2.2,-3.08528,53.3466,1401.0
493,2011,CH61 2,CH61 2,Total,619,294,325,619,0,13,65.62,9.4,-3.11806,53.3489,688.0
494,2011,CH61 3,CH61 3,Total,1576,734,842,1576,0,19,64.01,24.6,-3.10346,53.3534,1552.0
495,2011,CH61 4,CH61 4,Total,2867,1392,1475,2867,0,61,251.9,11.4,-3.11504,53.3537,2658.0
496,2011,CH61 5,CH61 5,Total,2599,1215,1384,2599,0,45,53.31,48.8,-3.1014,53.343,2237.0
497,2011,CH61 6,CH61 6,Total,2406,1114,1292,2359,47,36,105.56,22.8,-3.10101,53.337,2300.0
498,2011,CH61 7,CH61 7,Total,1923,920,1003,1923,0,22,122.71,15.7,-3.09084,53.352,1692.0
499,2011,CH61 8,CH61 8,Total,2154,1014,1140,2154,0,28,68.49,31.4,-3.10425,53.346,2189.0
500,2011,CH61 9,CH61 9,Total,1728,855,873,1695,33,37,94.04,18.4,-3.09677,53.3467,2081.0
501,2011,CH62 0,CH62 0,Total,1094,539,555,1094,0,14,202.26,5.4,-2.95939,53.3183,1294.0
502,2011,CH62 1,CH62 1,Total,3131,1583,1548,3131,0,16,79.19,39.5,-2.99492,53.3628,3017.0
503,2011,CH62 2,CH62 2,Total,3535,1709,1826,3421,114,38,164.91,21.4,-2.98631,53.3392,3028.0
504,2011,CH62 3,CH62 3,Total,1162,570,592,1162,0,6,48.0,24.2,-2.97576,53.3397,1343.0
505,2011,CH62 4,CH62 4,Total,1890,916,974,1866,24,8,224.48,8.4,-2.98899,53.3526,2030.0
506,2011,CH62 5,CH62 5,Total,2331,1077,1254,2266,65,15,76.11,30.6,-2.99854,53.3582,2422.0
507,2011,CH62 6,CH62 6,Total,3919,1926,1993,3911,8,59,124.31,31.5,-2.98168,53.3238,3292.0
508,2011,CH62 7,CH62 7,Total,3453,1650,1803,3453,0,38,197.47,17.5,-2.98195,53.3302,3619.0
509,2011,CH62 8,CH62 8,Total,4862,2363,2499,4860,2,29,132.83,36.6,-2.97338,53.3165,5312.0
510,2011,CH62 9,CH62 9,Total,3355,1580,1775,3355,0,21,289.05,11.6,-2.97188,53.3111,3316.0
511,2011,CH63 0,CH63 0,Total,4629,2317,2312,4584,45,74,208.78,22.2,-2.9922,53.3209,4492.0
512,2011,CH63 1,CH63 1,Total,307,141,166,307,0,1,59.19,5.2,-3.03812,53.3287,445.0
513,2011,CH63 2,CH63 2,Total,5002,2403,2599,4947,55,58,126.45,39.6,-3.01825,53.3517,4881.0
514,2011,CH63 3,CH63 3,Total,4382,2063,2319,4272,110,67,88.83,49.3,-3.00708,53.3465,4444.0
515,2011,CH63 4,CH63 4,Total,328,163,165,328,0,8,1047.05,0.3,-3.02837,53.3239,322.0
516,2011,CH63 5,CH63 5,Total,4120,1981,2139,4107,13,69,110.0,37.5,-3.02178,53.3619,4572.0
517,2011,CH63 6,CH63 6,Total,533,239,294,455,78,6,1211.22,0.4,-3.04343,53.345,310.0
518,2011,CH63 7,CH63 7,Total,3936,1834,2102,3936,0,37,116.94,33.7,-3.0044,53.3542,3585.0
519,2011,CH63 8,CH63 8,Total,2977,1451,1526,2977,0,35,71.29,41.8,-3.01998,53.3585,2947.0
520,2011,CH63 9,CH63 9,Total,4383,2100,2283,4299,84,61,311.06,14.1,-3.0031,53.3401,4560.0
521,2011,CH64 0,CH64 0,Total,2874,1371,1503,2863,11,67,189.04,15.2,-3.06223,53.2805,2864.0
522,2011,CH64 1,CH64 1,Total,1428,712,716,1410,18,45,450.15,3.2,-3.00465,53.2957,1333.0
523,2011,CH64 2,CH64 2,Total,1197,558,639,1197,0,28,129.37,9.3,-3.01266,53.2912,1294.0
524,2011,CH64 3,CH64 3,Total,1997,960,1037,1997,0,25,220.06,9.1,-3.0644,53.2976,2347.0
525,2011,CH64 4,CH64 4,Total,2756,1355,1401,2756,0,46,890.27,3.1,-3.05186,53.2821,2321.0
526,2011,CH64 5,CH64 5,Total,922,426,496,871,51,27,1162.57,0.8,-3.02477,53.2632,799.0
527,2011,CH64 6,CH64 6,Total,2928,1374,1554,2890,38,59,609.48,4.8,-3.07543,53.294,2768.0
528,2011,CH64 7,CH64 7,Total,292,147,145,292,0,1,221.25,1.3,-3.04235,53.2954,406.0
529,2011,CH64 8,CH64 8,Total,153,76,77,153,0,2,278.25,0.5,-3.02465,53.2775,255.0
530,2011,CH64 9,CH64 9,Total,4374,2115,2259,4349,25,39,292.24,15.0,-3.05888,53.2896,4640.0
531,2011,CH65 0,CH65 0,Total,1176,567,609,1160,16,4,48.38,24.3,-2.90126,53.2783,877.0
532,2011,CH65 2,CH65 2,Total,2588,1309,1279,2579,9,14,73.3,35.3,-2.90023,53.2863,2684.0
533,2011,CH65 3,CH65 3,Total,1138,591,547,1138,0,7,61.15,18.6,-2.91279,53.2867,1340.0
534,2011,CH65 4,CH65 4,Total,878,430,448,878,0,5,420.14,2.1,-2.89065,53.2822,805.0
535,2011,CH65 5,CH65 5,Total,3385,1672,1713,3385,0,13,1794.23,1.9,-2.89028,53.2741,3437.0
536,2011,CH65 6,CH65 6,Total,3195,1593,1602,3183,12,29,83.28,38.4,-2.90731,53.2695,3375.0
537,2011,CH65 7,CH65 7,Total,3659,1761,1898,3625,34,24,83.39,43.9,-2.91659,53.2766,3852.0
538,2011,CH65 8,CH65 8,Total,4688,2194,2494,4591,97,22,95.72,49.0,-2.90867,53.2813,4330.0
539,2011,CH65 9,CH65 9,Total,5664,2768,2896,5590,74,45,265.53,21.3,-2.89651,53.2693,5647.0
540,2011,CH66 1,CH66 1,Total,6055,2891,3164,5976,79,50,307.86,19.7,-2.93294,53.2891,6384.0
541,2011,CH66 2,CH66 2,Total,12803,6353,6450,12762,41,155,283.21,45.2,-2.92347,53.2657,12962.0
542,2011,CH66 3,CH66 3,Total,6076,2853,3223,6031,45,26,134.38,45.2,-2.93258,53.2802,5648.0
543,2011,CH66 4,CH66 4,Total,8583,4246,4337,8583,0,118,339.77,25.3,-2.94232,53.2782,8730.0
544,2011,CH66 5,CH66 5,Total,1004,471,533,979,25,21,199.41,5.0,-2.95475,53.2921,663.0
545,2011,CH66 6,CH66 6,Total,385,190,195,376,9,10,157.39,2.4,-2.9647,53.2989,298.0
546,2011,CH66 7,CH66 7,Total,186,100,86,186,0,6,490.0,0.4,-2.97517,53.2954,173.0
547,2011,CM11 1,CM11 1,Total,7237,3630,3607,7228,9,144,1348.0,5.4,0.452103,51.6338,7308.0
548,2011,CM11 2,CM11 2,Total,11764,5682,6082,11759,5,167,1262.52,9.3,0.436326,51.6166,11975.0
549,2011,CM12 0,CM12 0,Total,12334,6013,6321,12264,70,204,542.74,22.7,0.415588,51.6348,12501.0
550,2011,CM12 9,CM12 9,Total,7488,3659,3829,7484,4,119,1448.23,5.2,0.413668,51.6191,7542.0
551,2011,CM13 1,CM13 1,Total,8383,4055,4328,8302,81,146,1379.61,6.1,0.346429,51.6326,8543.0
552,2011,CM13 2,CM13 2,Total,10236,4904,5332,10232,4,218,434.67,23.5,0.332813,51.6213,10176.0
553,2011,CM13 3,CM13 3,Total,5875,2855,3020,5637,238,101,3692.82,1.6,0.324831,51.5929,5996.0
554,2011,CM14 4,CM14 4,Total,10536,5097,5439,10380,156,160,279.61,37.7,0.29712,51.619,10601.0
555,2011,CM14 5,CM14 5,Total,9210,4478,4732,9086,124,134,3229.23,2.9,0.287161,51.6178,8852.0
556,2011,CM15 0,CM15 0,Total,8835,4311,4524,8829,6,164,2643.63,3.3,0.299912,51.6615,8628.0
557,2011,CM15 8,CM15 8,Total,5759,2838,2921,5759,0,173,596.44,9.7,0.319696,51.6268,5650.0
558,2011,CM15 9,CM15 9,Total,8812,4225,4587,8625,187,115,709.71,12.4,0.294302,51.6319,8999.0
559,2011,CM16 4,CM16 4,Total,3688,1757,1931,3624,64,39,139.75,26.4,0.11066,51.6969,4152.0
560,2011,CM16 5,CM16 5,Total,3512,1679,1833,3511,1,49,195.62,18.0,0.105078,51.6992,3274.0
561,2011,CM16 6,CM16 6,Total,8034,3882,4152,7923,111,109,3035.2,2.6,0.136469,51.7154,8001.0
562,2011,CM16 7,CM16 7,Total,6862,3321,3541,6778,84,120,2600.74,2.6,0.114024,51.6856,6790.0
563,2011,CM17 0,CM17 0,Total,6859,3260,3599,6840,19,85,1969.6,3.5,0.150085,51.7828,6893.0
564,2011,CM17 9,CM17 9,Total,14437,6993,7444,14407,30,100,1625.15,8.9,0.133372,51.7651,14375.0
565,2011,CM18 6,CM18 6,Total,12859,6144,6715,12702,157,113,307.31,41.8,0.106167,51.7599,13020.0
566,2011,CM18 7,CM18 7,Total,11566,5602,5964,11560,6,109,257.55,44.9,0.103005,51.753,11474.0
567,2011,CM19 4,CM19 4,Total,10841,5324,5517,10836,5,107,272.06,39.8,0.0844326,51.7592,10997.0
568,2011,CM19 5,CM19 5,Total,7970,3928,4042,7938,32,75,988.94,8.1,0.0659448,51.7632,8310.0
569,2011,CM20 1,CM20 1,Total,6371,3112,3259,6299,72,43,496.06,12.8,0.0899889,51.7717,6147.0
570,2011,CM20 2,CM20 2,Total,4013,1978,2035,4011,2,26,1169.43,3.4,0.1082,51.7818,4044.0
571,2011,CM20 3,CM20 3,Total,11016,5288,5728,10940,76,90,257.01,42.9,0.10976,51.772,11050.0
572,2011,CM21 0,CM21 0,Total,4308,2128,2180,4176,132,87,2289.68,1.9,0.136057,51.8114,4230.0
573,2011,CM21 9,CM21 9,Total,6530,3221,3309,6530,0,89,424.83,15.4,0.153888,51.8123,6635.0
574,2011,CM22 6,CM22 6,Total,6840,3383,3457,6813,27,122,4446.3,1.5,0.232166,51.8945,7242.0
575,2011,CM22 7,CM22 7,Total,6392,3151,3241,6358,34,134,5584.14,1.1,0.20048,51.8322,6470.0
576,2011,CM23 1,CM23 1,Total,1552,769,783,1552,0,43,2604.19,0.6,0.154765,51.9103,1575.0
577,2011,CM23 2,CM23 2,Total,7264,3541,3723,7100,164,202,556.6,13.1,0.156649,51.8741,7247.0
578,2011,CM23 3,CM23 3,Total,9337,4599,4738,9310,27,104,203.62,45.9,0.159235,51.8639,9471.0
579,2011,CM23 4,CM23 4,Total,13349,6527,6822,13291,58,316,963.49,13.9,0.146803,51.8609,13120.0
580,2011,CM23 5,CM23 5,Total,9113,4439,4674,8817,296,188,675.41,13.5,0.174962,51.8715,8963.0
581,2011,CM24 8,CM24 8,Total,6669,3346,3323,6594,75,108,1647.0,4.0,0.200008,51.9005,6724.0
582,2011,CM77 6,CM77 6,Total,2646,1287,1359,2641,5,31,868.17,3.0,0.511387,51.8758,2787.0
583,2011,CM77 7,CM77 7,Total,7451,3571,3880,7445,6,91,400.61,18.6,0.53349,51.8637,7386.0
584,2011,CM77 8,CM77 8,Total,5298,2659,2639,5205,93,75,4017.98,1.3,0.584995,51.8664,5302.0
585,2011,CO10 0,CO10 0,Total,13376,6604,6772,13217,159,184,5394.78,2.5,0.763116,52.0439,13264.0
586,2011,CO10 1,CO10 1,Total,8320,4000,4320,8215,105,92,266.33,31.2,0.732818,52.0457,8295.0
587,2011,CO10 2,CO10 2,Total,4410,2093,2317,4286,124,35,450.45,9.8,0.738666,52.04,4554.0
588,2011,CO10 5,CO10 5,Total,2263,1138,1125,2256,7,63,3036.57,0.7,0.851462,52.0203,2382.0
589,2011,CO10 7,CO10 7,Total,6438,3221,3217,6419,19,109,8213.41,0.8,0.683513,52.0593,6428.0
590,2011,CO10 8,CO10 8,Total,5356,2576,2780,5314,42,73,6681.18,0.8,0.59126,52.0825,5546.0
591,2011,CO10 9,CO10 9,Total,6166,2994,3172,6074,92,94,5838.29,1.1,0.753474,52.0889,6135.0
592,2011,CO11 1,CO11 1,Total,5643,2708,2935,5643,0,66,985.86,5.7,1.06959,51.9512,5596.0
593,2011,CO11 2,CO11 2,Total,7307,3575,3732,7226,81,107,5083.18,1.4,1.08105,51.9338,7382.0
594,2011,CO12 3,CO12 3,Total,6974,3475,3499,6873,101,42,305.74,22.8,1.27898,51.9377,7060.0
595,2011,CO12 4,CO12 4,Total,11264,5403,5861,11226,38,81,516.66,21.8,1.25728,51.9346,11238.0
596,2011,CO12 5,CO12 5,Total,3977,1956,2021,3947,30,49,3249.24,1.2,1.20813,51.9172,3953.0
597,2011,CO13 0,CO13 0,Total,8108,3814,4294,8027,81,99,1594.21,5.1,1.23117,51.8415,8278.0
598,2011,CO13 9,CO13 9,Total,4002,1814,2188,3921,81,72,200.37,20.0,1.24665,51.834,4002.0
599,2011,CO14 8,CO14 8,Total,6735,3018,3717,6538,197,58,698.89,9.6,1.26754,51.8503,6660.0
600,2011,CO15 1,CO15 1,Total,7233,3414,3819,6660,573,51,250.47,28.9,1.14781,51.7881,7045.0
601,2011,CO15 2,CO15 2,Total,6493,3127,3366,6447,46,21,374.11,17.4,1.1197,51.7821,6485.0
602,2011,CO15 3,CO15 3,Total,8623,4134,4489,8600,23,56,145.74,59.2,1.14868,51.7981,9193.0
603,2011,CO15 4,CO15 4,Total,8117,3796,4321,8111,6,43,561.01,14.5,1.16132,51.8102,8224.0
604,2011,CO15 5,CO15 5,Total,6741,3174,3567,6672,69,44,296.76,22.7,1.1861,51.8032,6795.0
605,2011,CO15 6,CO15 6,Total,5847,2710,3137,5517,330,58,191.36,30.6,1.16344,51.7959,5733.0
606,2011,CO16 0,CO16 0,Total,3036,1514,1522,2948,88,37,4369.05,0.7,1.15456,51.8603,2826.0
607,2011,CO16 7,CO16 7,Total,4919,2360,2559,4919,0,30,178.38,27.6,1.13039,51.7981,4725.0
608,2011,CO16 8,CO16 8,Total,10919,5197,5722,10866,53,76,2194.31,5.0,1.10572,51.8003,10840.0
609,2011,CO16 9,CO16 9,Total,5322,2590,2732,5258,64,41,3330.94,1.6,1.13582,51.8333,5217.0
610,2011,CT10 1,CT10 1,Total,7056,3423,3633,6790,266,116,207.66,34.0,1.43658,51.3591,7280.0
611,2011,CT10 2,CT10 2,Total,10522,4893,5629,10256,266,145,520.22,20.2,1.42048,51.3597,10485.0
612,2011,CT10 3,CT10 3,Total,7325,3471,3854,7143,182,85,407.93,18.0,1.43116,51.3733,7197.0
613,2011,CT11 0,CT11 0,Total,7465,3598,3867,7409,56,75,265.36,28.1,1.3993,51.3337,7544.0
614,2011,CT11 7,CT11 7,Total,9169,4434,4735,8923,246,72,155.37,59.0,1.4171,51.3416,8810.0
615,2011,CT11 8,CT11 8,Total,5761,2790,2971,5710,51,53,86.53,66.6,1.42237,51.3368,5931.0
616,2011,CT11 9,CT11 9,Total,6811,3404,3407,6717,94,65,108.18,63.0,1.4117,51.3339,6943.0
617,2011,CT12 4,CT12 4,Total,3882,1885,1997,3866,16,48,2722.62,1.4,1.31688,51.3371,3754.0
618,2011,CT12 5,CT12 5,Total,2742,1333,1409,2736,6,33,747.85,3.7,1.36512,51.3415,2918.0
619,2011,CT12 6,CT12 6,Total,11202,5348,5854,11182,20,54,371.91,30.1,1.39963,51.3473,11102.0
620,2011,CT13 0,CT13 0,Total,5957,2837,3120,5891,66,82,2314.11,2.6,1.31381,51.2584,5839.0
621,2011,CT13 9,CT13 9,Total,2944,1444,1500,2889,55,61,1971.6,1.5,1.34452,51.2774,2834.0
622,2011,CT14 0,CT14 0,Total,2960,1445,1515,2790,170,43,3205.01,0.9,1.34192,51.2314,2796.0
623,2011,CT14 6,CT14 6,Total,5355,2642,2713,5347,8,44,105.32,50.8,1.40106,51.2282,5477.0
624,2011,CT14 7,CT14 7,Total,9173,4415,4758,8912,261,96,237.81,38.6,1.39681,51.2108,9380.0
625,2011,CT14 8,CT14 8,Total,2694,1314,1380,2613,81,36,1277.41,2.1,1.38844,51.1908,2484.0
626,2011,CT14 9,CT14 9,Total,14874,7054,7820,14682,192,141,529.08,28.1,1.38628,51.2171,15111.0
627,2011,CT15 4,CT15 4,Total,3706,1812,1894,3693,13,43,2091.79,1.8,1.2528,51.2076,3532.0
628,2011,CT15 5,CT15 5,Total,3289,1722,1567,2858,431,61,3662.27,0.9,1.31355,51.1691,3265.0
629,2011,CT15 6,CT15 6,Total,2499,1208,1291,2491,8,39,1303.18,1.9,1.37081,51.1535,2483.0
630,2011,CT15 7,CT15 7,Total,3744,1833,1911,3673,71,48,3983.95,0.9,1.2316,51.1557,3925.0
631,2011,CT16 1,CT16 1,Total,3447,1772,1675,3349,98,28,188.04,18.3,1.31202,51.1293,3590.0
632,2011,CT16 2,CT16 2,Total,10592,5222,5370,10557,35,64,385.4,27.5,1.29935,51.1409,10608.0
633,2011,CT16 3,CT16 3,Total,5584,2708,2876,5409,175,73,982.59,5.7,1.28692,51.1553,5595.0
634,2011,CT17 0,CT17 0,Total,12301,6114,6187,12153,148,99,549.0,22.4,1.29093,51.135,12108.0
635,2011,CT17 9,CT17 9,Total,9785,4972,4813,9490,295,90,709.27,13.8,1.30003,51.122,9738.0
636,2011,CT18 7,CT18 7,Total,10823,5315,5508,10782,41,112,1864.22,5.8,1.17455,51.1102,10925.0
637,2011,CT18 8,CT18 8,Total,3086,1476,1610,3065,21,53,2427.69,1.3,1.1081,51.1169,3432.0
638,2011,CT19 4,CT19 4,Total,9199,4426,4773,9199,0,58,395.24,23.3,1.14657,51.0884,8888.0
639,2011,CT19 5,CT19 5,Total,10233,5055,5178,10092,141,100,249.46,41.0,1.17257,51.0884,10567.0
640,2011,CT19 6,CT19 6,Total,9435,4520,4915,9434,1,65,411.74,22.9,1.1874,51.0884,9070.0
641,2011,CT20 1,CT20 1,Total,7046,3913,3133,6948,98,35,77.61,90.8,1.17574,51.0813,6933.0
642,2011,CT20 2,CT20 2,Total,7545,3741,3804,7141,404,60,182.79,41.3,1.1684,51.0785,7395.0
643,2011,CT20 3,CT20 3,Total,7879,4037,3842,7573,306,87,299.83,26.3,1.1439,51.0797,8273.0
644,2011,CT21 4,CT21 4,Total,4377,2087,2290,4310,67,93,3086.35,1.4,1.05984,51.0784,4590.0
645,2011,CT21 5,CT21 5,Total,6446,3008,3438,6160,286,73,505.15,12.8,1.09467,51.0733,6532.0
646,2011,CT21 6,CT21 6,Total,6324,2965,3359,6311,13,47,263.33,24.0,1.07219,51.0674,6093.0
647,2011,CV10 0,CV10 0,Total,12587,6102,6485,12519,68,112,2668.29,4.7,-1.49585,52.5379,12491.0
648,2011,CV10 7,CV10 7,Total,11078,5423,5655,10997,81,87,1455.15,7.6,-1.48376,52.5117,11273.0
649,2011,CV10 8,CV10 8,Total,11974,5914,6060,11969,5,71,305.05,39.3,-1.50405,52.5203,12060.0
650,2011,CV10 9,CV10 9,Total,14244,7027,7217,14198,46,114,1040.38,13.7,-1.51482,52.5276,14162.0
651,2011,CV11 4,CV11 4,Total,12061,5845,6216,11920,141,121,410.82,29.4,-1.45744,52.5147,11929.0
652,2011,CV11 5,CV11 5,Total,11114,5570,5544,11034,80,92,208.91,53.2,-1.47285,52.5226,10985.0
653,2011,CV11 6,CV11 6,Total,16253,8151,8102,15871,382,355,2340.48,6.9,-1.43867,52.5222,16611.0
654,2011,CV12 0,CV12 0,Total,9099,4431,4668,9050,49,91,645.17,14.1,-1.50039,52.4735,9057.0
655,2011,CV12 8,CV12 8,Total,10682,5243,5439,10571,111,73,276.22,38.7,-1.47778,52.4792,10580.0
656,2011,CV12 9,CV12 9,Total,11825,5768,6057,11807,18,91,1551.36,7.6,-1.44678,52.477,11866.0
657,2011,CV13 0,CV13 0,Total,6402,3165,3237,6341,61,133,5605.88,1.1,-1.3998,52.6268,6272.0
658,2011,CV13 6,CV13 6,Total,4312,2177,2135,4164,148,80,5590.53,0.8,-1.44115,52.5841,4280.0
659,2011,CV21 1,CV21 1,Total,9843,4856,4987,9829,14,110,539.11,18.3,-1.27074,52.3824,9902.0
660,2011,CV21 2,CV21 2,Total,7990,4104,3886,7913,77,59,178.51,44.8,-1.285,52.3687,7933.0
661,2011,CV21 3,CV21 3,Total,10227,5230,4997,10115,112,154,289.63,35.3,-1.29039,52.3612,9836.0
662,2011,CV21 4,CV21 4,Total,7530,3783,3747,7470,60,74,431.85,17.4,-1.24313,52.357,7470.0
663,2011,CV22 5,CV22 5,Total,9369,4682,4687,8724,645,167,744.11,12.6,-1.26397,52.3583,9802.0
664,2011,CV22 6,CV22 6,Total,10470,5041,5429,10237,233,167,442.58,23.7,-1.28741,52.3511,10375.0
665,2011,CV22 7,CV22 7,Total,15494,7561,7933,15324,170,223,1681.08,9.2,-1.29267,52.3628,15608.0
666,2011,CV23 0,CV23 0,Total,9612,4799,4813,9413,199,140,10135.28,0.9,-1.27764,52.3998,9710.0
667,2011,CV23 8,CV23 8,Total,5613,3281,2332,4496,1117,101,9105.78,0.6,-1.29484,52.2934,5641.0
668,2011,CV23 9,CV23 9,Total,6611,3284,3327,6557,54,123,5753.19,1.1,-1.35177,52.3543,6617.0
669,2011,CV31 1,CV31 1,Total,12171,6178,5993,12030,141,130,1065.37,11.4,-1.51641,52.281,12160.0
670,2011,CV31 2,CV31 2,Total,12287,6231,6056,12235,52,152,507.53,24.2,-1.52685,52.272,11800.0
671,2011,CV31 3,CV31 3,Total,7072,3790,3282,6895,177,61,168.72,41.9,-1.53643,52.2814,7602.0
672,2011,CV32 4,CV32 4,Total,3149,1593,1556,3128,21,39,320.53,9.8,-1.53166,52.2905,3377.0
673,2011,CV32 5,CV32 5,Total,8230,4205,4025,7912,318,117,155.56,52.9,-1.53708,52.2921,7634.0
674,2011,CV32 6,CV32 6,Total,7490,3667,3823,7294,196,153,673.53,11.1,-1.54299,52.2973,7927.0
675,2011,CV32 7,CV32 7,Total,13827,6728,7099,13712,115,177,1045.98,13.2,-1.51645,52.3041,13735.0
676,2011,CV33 9,CV33 9,Total,6103,3000,3103,6087,16,105,7039.72,0.9,-1.49291,52.2583,6256.0
677,2011,CV34 4,CV34 4,Total,4831,2386,2445,4724,107,48,216.83,22.3,-1.58748,52.2844,5056.0
678,2011,CV34 5,CV34 5,Total,14218,7120,7098,14110,108,161,551.36,25.8,-1.58505,52.2917,13944.0
679,2011,CV34 6,CV34 6,Total,12296,6047,6249,12284,12,226,1422.06,8.6,-1.57495,52.2739,12269.0
680,2011,CV35 0,CV35 0,Total,5786,2822,2964,5678,108,146,8660.19,0.7,-1.523,52.165,5680.0
681,2011,CV35 7,CV35 7,Total,5310,2631,2679,5297,13,140,5306.83,1.0,-1.64056,52.3099,5081.0
682,2011,CV35 8,CV35 8,Total,5676,2747,2929,5676,0,153,4269.16,1.3,-1.64291,52.2704,5962.0
683,2011,CV35 9,CV35 9,Total,7837,3746,4091,7633,204,157,5935.15,1.3,-1.59162,52.2051,7814.0
684,2011,CV36 4,CV36 4,Total,6496,3095,3401,6450,46,113,2999.17,2.2,-1.6483,52.083,6621.0
685,2011,CV36 5,CV36 5,Total,2790,1362,1428,2785,5,75,7796.51,0.4,-1.60219,52.0526,2794.0
686,2011,CV37 0,CV37 0,Total,6733,3313,3420,6628,105,104,5122.64,1.3,-1.70805,52.2163,6978.0
687,2011,CV37 6,CV37 6,Total,6679,3111,3568,6506,173,86,263.93,25.3,-1.70927,52.1947,5932.0
688,2011,CV37 7,CV37 7,Total,8658,4202,4456,8551,107,209,3151.95,2.7,-1.67411,52.1819,8728.0
689,2011,CV37 8,CV37 8,Total,6969,3415,3554,6925,44,182,10952.52,0.6,-1.7385,52.1405,6675.0
690,2011,CV37 9,CV37 9,Total,11959,5804,6155,11775,184,177,3204.74,3.7,-1.73651,52.1961,12126.0
691,2011,CV47 0,CV47 0,Total,2213,1044,1169,2213,0,19,128.64,17.2,-1.39421,52.2524,2672.0
692,2011,CV47 1,CV47 1,Total,4354,2162,2192,4278,76,81,1133.25,3.8,-1.38303,52.2497,3845.0
693,2011,CV47 2,CV47 2,Total,5145,2596,2549,5035,110,72,9035.13,0.6,-1.41127,52.2057,5199.0
694,2011,CV47 7,CV47 7,Total,751,368,383,751,0,22,2067.8,0.4,-1.30853,52.2159,744.0
695,2011,CV47 8,CV47 8,Total,2491,1260,1231,2491,0,60,3057.28,0.8,-1.34936,52.2566,2404.0
696,2011,CV47 9,CV47 9,Total,2013,966,1047,1988,25,39,1315.74,1.5,-1.39461,52.2797,1972.0
697,2011,CW10 0,CW10 0,Total,7597,3743,3854,7555,42,79,1013.08,7.5,-2.44593,53.1813,8060.0
698,2011,CW10 9,CW10 9,Total,6764,3356,3408,6701,63,85,2502.85,2.7,-2.45235,53.1977,6730.0
699,2011,CW11 1,CW11 1,Total,7236,3513,3723,7169,67,144,2834.98,2.6,-2.36494,53.1491,7042.0
700,2011,CW11 2,CW11 2,Total,1889,898,991,1858,31,38,1232.89,1.5,-2.31918,53.1451,2029.0
701,2011,CW11 3,CW11 3,Total,7181,3571,3610,7134,47,117,2467.63,2.9,-2.39152,53.1441,6963.0
702,2011,CW11 4,CW11 4,Total,6309,3100,3209,6305,4,118,2013.69,3.1,-2.36106,53.1337,6287.0
703,2011,CW12 1,CW12 1,Total,3872,1960,1912,3768,104,33,157.58,24.6,-2.21377,53.1678,4182.0
704,2011,CW12 2,CW12 2,Total,4934,2424,2510,4926,8,68,3447.26,1.4,-2.20812,53.1791,4664.0
705,2011,CW12 3,CW12 3,Total,10059,4970,5089,9939,120,153,1667.68,6.0,-2.19683,53.1579,10270.0
706,2011,CW12 4,CW12 4,Total,10360,5046,5314,10251,109,150,2777.83,3.7,-2.2369,53.1645,10201.0
707,2011,DA10 0,DA10 0,Total,6746,3348,3398,6738,8,45,385.83,17.5,0.305221,51.4449,6658.0
708,2011,DA11 0,DA11 0,Total,8909,4556,4353,8720,189,100,124.2,71.7,0.363854,51.4401,9043.0
709,2011,DA11 7,DA11 7,Total,9009,4361,4648,8971,38,94,232.54,38.7,0.360589,51.4269,9231.0
710,2011,DA11 8,DA11 8,Total,10962,5328,5634,10803,159,78,326.18,33.6,0.343934,51.4303,11217.0
711,2011,DA11 9,DA11 9,Total,9179,4580,4599,9119,60,58,350.98,26.2,0.340736,51.4437,9127.0
712,2011,DA12 1,DA12 1,Total,6711,3454,3257,6584,127,77,124.5,53.9,0.374123,51.4372,6919.0
713,2011,DA12 2,DA12 2,Total,8904,4509,4395,8903,1,68,521.6,17.1,0.384188,51.4394,9002.0
714,2011,DA12 3,DA12 3,Total,2356,1136,1220,2282,74,34,2346.37,1.0,0.416294,51.408,2338.0
715,2011,DA12 4,DA12 4,Total,14437,7045,7392,14437,0,142,444.3,32.5,0.393889,51.4251,13969.0
716,2011,DA12 5,DA12 5,Total,14984,7227,7757,14934,50,148,279.09,53.7,0.378369,51.4229,14792.0
717,2011,DA13 0,DA13 0,Total,9007,4394,4613,8978,29,151,2899.96,3.1,0.361678,51.3705,8954.0
718,2011,DA13 9,DA13 9,Total,5442,2672,2770,5392,50,89,1887.59,2.9,0.342247,51.4106,5240.0
719,2011,DA14 4,DA14 4,Total,9774,4629,5145,9759,15,113,246.84,39.6,0.111913,51.4306,9836.0
720,2011,DA14 5,DA14 5,Total,4193,1978,2215,4174,19,29,603.69,6.9,0.123327,51.4198,4594.0
721,2011,DA14 6,DA14 6,Total,7216,3213,4003,7091,125,66,202.2,35.7,0.100569,51.4254,7452.0
722,2011,DA15 7,DA15 7,Total,5408,2619,2789,5115,293,72,101.52,53.3,0.0968553,51.4325,5211.0
723,2011,DA15 8,DA15 8,Total,14900,7196,7704,14783,117,136,251.13,59.3,0.0939927,51.4441,15319.0
724,2011,DA15 9,DA15 9,Total,9119,4440,4679,9119,0,118,239.94,38.0,0.107544,51.4438,8593.0
725,2011,DA16 1,DA16 1,Total,12574,6086,6488,12574,0,132,172.8,72.8,0.119198,51.4671,12550.0
726,2011,DA16 2,DA16 2,Total,14284,6906,7378,14284,0,181,245.72,58.1,0.103272,51.4597,13887.0
727,2011,DA16 3,DA16 3,Total,9054,4348,4706,8991,63,80,188.84,47.9,0.104088,51.4667,9459.0
728,2011,DA17 5,DA17 5,Total,10470,5054,5416,10457,13,96,169.28,61.9,0.143773,51.4862,10565.0
729,2011,DA17 6,DA17 6,Total,6634,3169,3465,6634,0,55,305.52,21.7,0.155467,51.4897,6564.0
730,2011,DA18 4,DA18 4,Total,4939,2397,2542,4925,14,68,278.86,17.7,0.145746,51.4915,4851.0
731,2011,DE11 0,DE11 0,Total,15296,7592,7704,15279,17,102,616.26,24.8,-1.56738,52.7815,15480.0
732,2011,DE11 7,DE11 7,Total,9745,4839,4906,9694,51,92,1325.31,7.4,-1.53341,52.7751,9854.0
733,2011,DE11 8,DE11 8,Total,6022,2992,3030,6008,14,49,847.66,7.1,-1.54074,52.7667,5612.0
734,2011,DE11 9,DE11 9,Total,12746,6366,6380,12628,118,106,743.19,17.2,-1.57024,52.7645,12804.0
735,2011,DE12 6,DE12 6,Total,7566,3705,3861,7516,50,67,1435.57,5.3,-1.55709,52.7434,7788.0
736,2011,DE12 7,DE12 7,Total,9101,4598,4503,9097,4,106,2838.29,3.2,-1.52153,52.7123,9165.0
737,2011,DE12 8,DE12 8,Total,3795,1899,1896,3652,143,53,5308.46,0.7,-1.61626,52.7317,3740.0
738,2011,DE13 0,DE13 0,Total,18922,9168,9754,18782,140,182,861.88,22.0,-1.63777,52.8266,18897.0
739,2011,DE13 7,DE13 7,Total,4128,1999,2129,4076,52,82,2478.43,1.7,-1.75473,52.7462,4076.0
740,2011,DE13 8,DE13 8,Total,7962,3823,4139,7885,77,169,8511.95,0.9,-1.73635,52.7821,7835.0
741,2011,DE13 9,DE13 9,Total,9584,4684,4900,9558,26,166,4605.99,2.1,-1.68002,52.8329,9519.0
742,2011,DE14 1,DE14 1,Total,2468,1300,1168,2427,41,17,480.67,5.1,-1.62989,52.8093,2630.0
743,2011,DE14 2,DE14 2,Total,12501,6192,6309,12423,78,94,422.78,29.6,-1.6447,52.8113,12258.0
744,2011,DE14 3,DE14 3,Total,13875,7072,6803,13783,92,113,925.74,15.0,-1.64582,52.7973,14087.0
745,2011,DE15 0,DE15 0,Total,9676,4710,4966,9397,279,91,1849.24,5.2,-1.59782,52.809,9776.0
746,2011,DE15 9,DE15 9,Total,14516,7102,7414,14382,134,154,1873.21,7.7,-1.62012,52.7918,14323.0
747,2011,DE21 2,DE21 2,Total,10435,5154,5281,10414,21,113,236.6,44.1,-1.43428,52.9418,10177.0
748,2011,DE21 4,DE21 4,Total,13248,6397,6851,13192,56,72,381.24,34.7,-1.44858,52.9375,13296.0
749,2011,DE21 5,DE21 5,Total,3623,1763,1860,3613,10,83,1467.43,2.5,-1.45675,52.9638,3499.0
750,2011,DE21 6,DE21 6,Total,17333,8466,8867,17219,114,92,607.09,28.6,-1.44185,52.9256,17621.0
751,2011,DE21 7,DE21 7,Total,12377,6064,6313,12267,110,92,797.01,15.5,-1.40888,52.918,12431.0
752,2011,DE22 1,DE22 1,Total,6464,3143,3321,6302,162,116,315.17,20.5,-1.48312,52.936,6359.0
753,2011,DE22 2,DE22 2,Total,13622,6598,7024,13621,1,257,647.61,21.0,-1.49096,52.9479,13560.0
754,2011,DE22 3,DE22 3,Total,17663,9156,8507,16770,893,113,321.67,54.9,-1.49564,52.9191,17600.0
755,2011,DE22 4,DE22 4,Total,7862,3740,4122,7856,6,53,1426.12,5.5,-1.52207,52.9264,7480.0
756,2011,DE22 5,DE22 5,Total,933,476,457,933,0,33,448.98,2.1,-1.51281,52.9651,1004.0
757,2011,DE23 1,DE23 1,Total,8516,4096,4420,8374,142,100,174.11,48.9,-1.49779,52.8934,9036.0
758,2011,DE23 2,DE23 2,Total,3042,1419,1623,3042,0,29,107.71,28.2,-1.50723,52.8885,3016.0
759,2011,DE23 3,DE23 3,Total,6045,2945,3100,6045,0,133,146.32,41.3,-1.52189,52.8941,6147.0
760,2011,DE23 4,DE23 4,Total,2686,1278,1408,2686,0,60,169.69,15.8,-1.52881,52.8983,2778.0
761,2011,DE23 6,DE23 6,Total,18975,9539,9436,18713,262,247,306.01,62.0,-1.49235,52.9079,18530.0
762,2011,DE23 8,DE23 8,Total,20636,10467,10169,20400,236,110,292.78,70.5,-1.47656,52.9042,20472.0
763,2011,DE24 0,DE24 0,Total,15565,7622,7943,15450,115,94,478.23,32.5,-1.42682,52.8914,15833.0
764,2011,DE24 1,DE24 1,Total,1010,527,483,1010,0,4,92.07,11.0,-1.44535,52.9074,1051.0
765,2011,DE24 3,DE24 3,Total,6249,3133,3116,6249,0,58,274.75,22.7,-1.49866,52.8754,6526.0
766,2011,DE24 5,DE24 5,Total,1287,661,626,1287,0,13,180.12,7.1,-1.41684,52.8837,1088.0
767,2011,DE24 8,DE24 8,Total,16740,8218,8522,16582,158,89,593.59,28.2,-1.45063,52.901,16488.0
768,2011,DE24 9,DE24 9,Total,13672,6587,7085,13538,134,94,438.09,31.2,-1.4668,52.8845,13411.0
769,2011,DE45 1,DE45 1,Total,8676,4087,4589,8398,278,195,13050.21,0.7,-1.6776,53.2143,8764.0
770,2011,DE55 1,DE55 1,Total,6751,3336,3415,6719,32,88,557.63,12.1,-1.38752,53.0775,7233.0
771,2011,DE55 2,DE55 2,Total,7161,3561,3600,7109,52,42,652.33,11.0,-1.33903,53.1038,7342.0
772,2011,DE55 3,DE55 3,Total,3781,1935,1846,3758,23,30,179.96,21.0,-1.34397,53.0955,3551.0
773,2011,DE55 4,DE55 4,Total,8558,4230,4328,8529,29,39,916.67,9.3,-1.3666,53.0775,8173.0
774,2011,DE55 5,DE55 5,Total,8176,4016,4160,8083,93,57,1661.89,4.9,-1.34689,53.1278,8152.0
775,2011,DE55 6,DE55 6,Total,7312,3563,3749,7253,59,62,3216.78,2.3,-1.41085,53.1284,7194.0
776,2011,DE55 7,DE55 7,Total,9485,4644,4841,9308,177,67,1816.49,5.2,-1.38865,53.0951,9537.0
777,2011,DE56 0,DE56 0,Total,12408,6046,6362,12260,148,165,1507.49,8.2,-1.45648,53.0142,12161.0
778,2011,DE56 1,DE56 1,Total,13418,6568,6850,13244,174,130,446.22,30.1,-1.47634,53.024,13493.0
779,2011,DE56 2,DE56 2,Total,9172,4626,4546,9097,75,129,7481.56,1.2,-1.48797,53.0436,8734.0
780,2011,DE56 4,DE56 4,Total,5376,2598,2778,5316,60,180,1283.64,4.2,-1.49197,52.9915,5430.0
781,2011,DE65 5,DE65 5,Total,11968,5871,6097,11783,185,129,4364.28,2.7,-1.65734,52.8731,11896.0
782,2011,DE65 6,DE65 6,Total,11488,5740,5748,10751,737,219,7524.29,1.5,-1.57368,52.8605,11179.0
783,2011,DE72 2,DE72 2,Total,4120,2020,2100,4088,32,74,2071.95,2.0,-1.38187,52.8653,4147.0
784,2011,DE72 3,DE72 3,Total,16105,7788,8317,15910,195,211,3811.36,4.2,-1.36185,52.9038,16306.0
785,2011,DE73 5,DE73 5,Total,4815,2366,2449,4796,19,62,186.24,25.9,-1.44564,52.8704,5045.0
786,2011,DE73 6,DE73 6,Total,6566,3162,3404,6557,9,95,223.54,29.4,-1.43466,52.8717,6314.0
787,2011,DE73 7,DE73 7,Total,1799,909,890,1799,0,38,3837.19,0.5,-1.47332,52.8381,1895.0
788,2011,DE73 8,DE73 8,Total,5872,2900,2972,5857,15,135,3188.94,1.8,-1.42383,52.8259,5792.0
789,2011,DE74 2,DE74 2,Total,11491,5762,5729,11363,128,160,4414.29,2.6,-1.33942,52.8474,11268.0
790,2011,DE75 7,DE75 7,Total,18713,9233,9480,18595,118,131,1463.54,12.8,-1.35445,53.0131,18589.0
791,2011,DL10 4,DL10 4,Total,5249,2548,2701,5192,57,85,1052.86,5.0,-1.74141,54.4073,5307.0
792,2011,DL10 5,DL10 5,Total,3414,1605,1809,3410,4,77,3323.54,1.0,-1.71426,54.4345,3518.0
793,2011,DL10 6,DL10 6,Total,2858,1403,1455,2720,138,62,5937.66,0.5,-1.63301,54.434,2987.0
794,2011,DL10 7,DL10 7,Total,6903,3639,3264,6235,668,142,2501.99,2.8,-1.67727,54.3902,7066.0
795,2011,DL11 6,DL11 6,Total,2030,1011,1019,2018,12,44,30873.11,0.1,-1.97975,54.3921,2020.0
796,2011,DL11 7,DL11 7,Total,3278,1652,1626,3262,16,94,23415.93,0.1,-1.77881,54.4791,3015.0
797,2011,DL12 0,DL12 0,Total,2494,1241,1253,2483,11,33,29750.9,0.1,-2.09311,54.6269,2522.0
798,2011,DL12 8,DL12 8,Total,6802,3217,3585,6425,377,109,5728.14,1.2,-1.91175,54.5508,6767.0
799,2011,DL12 9,DL12 9,Total,3111,1771,1340,2637,474,63,18595.23,0.2,-1.97027,54.5444,3226.0
800,2011,DL13 1,DL13 1,Total,1481,732,749,1478,3,22,10357.0,0.1,-2.17901,54.7427,1481.0
801,2011,DL13 2,DL13 2,Total,3100,1563,1537,3056,44,47,15199.72,0.2,-2.00822,54.7449,3116.0
802,2011,DL13 3,DL13 3,Total,3119,1516,1603,3119,0,49,14286.2,0.2,-1.86378,54.7124,3041.0
803,2011,DL13 4,DL13 4,Total,3154,1576,1578,3122,32,21,4425.71,0.7,-1.813,54.7488,3117.0
804,2011,DL13 5,DL13 5,Total,3304,1648,1656,3303,1,22,4466.78,0.7,-1.83156,54.6238,3146.0
805,2011,DL14 0,DL14 0,Total,6311,3076,3235,6257,54,90,1981.48,3.2,-1.73927,54.6544,6514.0
806,2011,DL14 6,DL14 6,Total,11580,5412,6168,11340,240,108,414.35,27.9,-1.67855,54.6512,11344.0
807,2011,DL14 7,DL14 7,Total,4682,2250,2432,4617,65,57,785.32,6.0,-1.68091,54.663,4773.0
808,2011,DL14 8,DL14 8,Total,6803,3405,3398,6773,30,31,2092.08,3.3,-1.64136,54.661,6669.0
809,2011,DL14 9,DL14 9,Total,7696,3714,3982,7590,106,54,2104.89,3.7,-1.72178,54.6318,8029.0
810,2011,DL15 0,DL15 0,Total,8730,4332,4398,8607,123,81,2119.67,4.1,-1.69589,54.7075,8838.0
811,2011,DL15 8,DL15 8,Total,5297,2580,2717,5235,62,34,2252.22,2.4,-1.74953,54.7013,5124.0
812,2011,DL15 9,DL15 9,Total,8470,4126,4344,8407,63,70,1279.17,6.6,-1.74823,54.7178,8510.0
813,2011,DL16 6,DL16 6,Total,11219,5503,5716,11219,0,98,974.15,11.5,-1.59466,54.7041,11177.0
814,2011,DL16 7,DL16 7,Total,8597,4242,4355,8549,48,72,2074.03,4.1,-1.61511,54.6937,8574.0
815,2011,DL17 0,DL17 0,Total,4954,2419,2535,4918,36,41,1765.61,2.8,-1.55368,54.6655,5013.0
816,2011,DL17 8,DL17 8,Total,8942,4357,4585,8871,71,47,870.62,10.3,-1.55329,54.6877,8833.0
817,2011,DL17 9,DL17 9,Total,3776,1847,1929,3742,34,32,1688.09,2.2,-1.51182,54.6938,3886.0
818,2011,DN10 4,DN10 4,Total,5286,2637,2649,5241,45,92,5722.11,0.9,-0.857951,53.4259,5320.0
819,2011,DN10 5,DN10 5,Total,1631,820,811,1555,76,44,2537.78,0.6,-0.962772,53.4052,1723.0
820,2011,DN10 6,DN10 6,Total,5169,2542,2627,5159,10,109,5527.21,0.9,-1.01519,53.4349,5270.0
821,2011,DN11 0,DN11 0,Total,13537,6543,6994,13354,183,83,1230.34,11.0,-1.07149,53.4757,13528.0
822,2011,DN11 8,DN11 8,Total,8294,4041,4253,8177,117,55,1549.24,5.4,-1.06364,53.4189,8171.0
823,2011,DN11 9,DN11 9,Total,6521,3090,3431,6425,96,102,4619.12,1.4,-1.11809,53.4461,6677.0
824,2011,DN12 1,DN12 1,Total,7856,3819,4037,7812,44,36,780.08,10.1,-1.18821,53.4819,7801.0
825,2011,DN12 2,DN12 2,Total,5928,2908,3020,5922,6,37,197.27,30.1,-1.23083,53.4785,6044.0
826,2011,DN12 3,DN12 3,Total,5803,2805,2998,5742,61,27,223.99,25.9,-1.23155,53.4836,5949.0
827,2011,DN12 4,DN12 4,Total,4532,2174,2358,4448,84,19,463.77,9.8,-1.25173,53.4889,4370.0
828,2011,DN14 0,DN14 0,Total,7301,3653,3648,7268,33,84,6632.4,1.1,-1.11509,53.6954,7269.0
829,2011,DN14 5,DN14 5,Total,7850,3904,3946,7725,125,48,478.16,16.4,-0.866385,53.7049,7832.0
830,2011,DN14 6,DN14 6,Total,12960,6285,6675,12787,173,88,538.33,24.1,-0.878348,53.7089,12862.0
831,2011,DN14 7,DN14 7,Total,7172,3570,3602,7142,30,69,10997.93,0.7,-0.851343,53.7437,7305.0
832,2011,DN14 8,DN14 8,Total,4824,2400,2424,4733,91,53,9305.28,0.5,-0.891863,53.6923,4978.0
833,2011,DN14 9,DN14 9,Total,6135,2955,3180,6082,53,86,5331.12,1.2,-1.0198,53.6905,6087.0
834,2011,DN15 0,DN15 0,Total,1067,523,544,981,86,13,4221.78,0.3,-0.586924,53.6196,1051.0
835,2011,DN15 6,DN15 6,Total,5106,2683,2423,5070,36,30,464.1,11.0,-0.64841,53.5916,4851.0
836,2011,DN15 7,DN15 7,Total,8581,4364,4217,8495,86,81,217.05,39.5,-0.664404,53.5898,8886.0
837,2011,DN15 8,DN15 8,Total,12187,6048,6139,12061,126,111,2461.06,5.0,-0.676338,53.5987,12137.0
838,2011,DN15 9,DN15 9,Total,9662,4816,4846,9623,39,107,6880.19,1.4,-0.630472,53.6571,9682.0
839,2011,DN16 1,DN16 1,Total,9044,4425,4619,8999,45,60,1040.65,8.7,-0.637097,53.5791,8664.0
840,2011,DN16 2,DN16 2,Total,8659,4200,4459,8559,100,56,200.56,43.2,-0.642562,53.5694,9039.0
841,2011,DN16 3,DN16 3,Total,13964,6829,7135,13854,110,153,1607.78,8.7,-0.640508,53.5593,14056.0
842,2011,DN17 1,DN17 1,Total,12004,5913,6091,11920,84,95,430.66,27.9,-0.672182,53.5744,11911.0
843,2011,DN17 2,DN17 2,Total,11511,5598,5913,11425,86,88,1406.61,8.2,-0.667215,53.5603,11531.0
844,2011,DN17 3,DN17 3,Total,7315,3626,3689,7275,40,88,5427.36,1.3,-0.698534,53.5501,7406.0
845,2011,DN17 4,DN17 4,Total,6358,3216,3142,6324,34,89,8126.98,0.8,-0.792941,53.6133,6359.0
846,2011,DN18 5,DN18 5,Total,8684,4254,4430,8594,90,86,486.29,17.9,-0.442025,53.6853,8904.0
847,2011,DN18 6,DN18 6,Total,3033,1437,1596,3017,16,33,2717.2,1.1,-0.457943,53.6729,3028.0
848,2011,DN19 7,DN19 7,Total,6282,3136,3146,6206,76,75,4365.04,1.4,-0.36397,53.6844,6296.0
849,2011,DN20 0,DN20 0,Total,6875,3338,3537,6754,121,82,8404.23,0.8,-0.513864,53.5837,6637.0
850,2011,DN20 8,DN20 8,Total,6812,3354,3458,6669,143,84,1396.53,4.9,-0.484353,53.5557,6583.0
851,2011,DN20 9,DN20 9,Total,5500,2707,2793,5464,36,79,2462.05,2.2,-0.518382,53.5317,6153.0
852,2011,DN21 1,DN21 1,Total,11713,5724,5989,11548,165,73,757.6,15.5,-0.763447,53.3967,12060.0
853,2011,DN21 2,DN21 2,Total,6795,3274,3521,6778,17,60,212.76,31.9,-0.777643,53.4034,6433.0
854,2011,DN21 3,DN21 3,Total,7346,3562,3784,7155,191,96,9314.84,0.8,-0.719223,53.4592,7356.0
855,2011,DN21 4,DN21 4,Total,5138,2580,2558,5006,132,93,10609.03,0.5,-0.574613,53.4656,5077.0
856,2011,DN21 5,DN21 5,Total,6229,3066,3163,6098,131,92,14079.54,0.4,-0.67227,53.3791,6140.0
857,2011,DN22 0,DN22 0,Total,4803,2549,2254,4354,449,88,8725.5,0.6,-0.855843,53.3045,4771.0
858,2011,DN22 6,DN22 6,Total,7447,3617,3830,7256,191,87,695.57,10.7,-0.939278,53.3239,6971.0
859,2011,DN22 7,DN22 7,Total,14903,7300,7603,14813,90,189,1187.29,12.6,-0.948846,53.3182,15215.0
860,2011,DN22 8,DN22 8,Total,5826,3365,2461,4690,1136,92,8915.22,0.7,-0.988556,53.3315,5934.0
861,2011,DN22 9,DN22 9,Total,3107,1540,1567,3107,0,60,7771.72,0.4,-0.878067,53.3571,3052.0
862,2011,DN31 1,DN31 1,Total,1928,966,962,1928,0,2,193.89,9.9,-0.0855478,53.5676,1813.0
863,2011,DN31 2,DN31 2,Total,7481,3675,3806,7461,20,48,191.89,39.0,-0.0984552,53.57,7533.0
864,2011,DN31 3,DN31 3,Total,210,122,88,210,0,0,11.93,17.6,-0.0701174,53.5756,254.0
865,2011,DN32 0,DN32 0,Total,6619,3353,3266,6408,211,91,198.19,33.4,-0.0830807,53.5594,6374.0
866,2011,DN32 7,DN32 7,Total,6663,3494,3169,6641,22,26,200.46,33.2,-0.0678717,53.5709,6980.0
867,2011,DN32 8,DN32 8,Total,8466,4133,4333,8458,8,42,257.25,32.9,-0.0591905,53.5601,7928.0
868,2011,DN32 9,DN32 9,Total,8509,4344,4165,8364,145,39,169.69,50.1,-0.0730329,53.5616,8686.0
869,2011,DN33 1,DN33 1,Total,7111,3381,3730,7069,42,34,139.47,51.0,-0.105791,53.5477,6985.0
870,2011,DN33 2,DN33 2,Total,5126,2468,2658,4977,149,72,228.75,22.4,-0.088644,53.5391,5491.0
871,2011,DN33 3,DN33 3,Total,7301,3538,3763,7255,46,72,210.0,34.8,-0.100397,53.5359,7060.0
872,2011,DN34 4,DN34 4,Total,8407,4040,4367,8214,193,93,205.58,40.9,-0.106667,53.5625,8350.0
873,2011,DN34 5,DN34 5,Total,10594,5125,5469,10462,132,64,307.65,34.4,-0.116662,53.5543,10921.0
874,2011,DN35 0,DN35 0,Total,8606,4078,4528,8536,70,93,439.97,19.6,-0.0280641,53.5455,8823.0
875,2011,DN35 7,DN35 7,Total,11839,5866,5973,11818,21,61,169.26,69.9,-0.0486542,53.5669,11707.0
876,2011,DN35 8,DN35 8,Total,8185,4030,4155,7972,213,45,130.88,62.5,-0.0332038,53.558,8152.0
877,2011,DN35 9,DN35 9,Total,5931,2820,3111,5930,1,38,142.23,41.7,-0.0447367,53.5509,5898.0
878,2011,DN36 4,DN36 4,Total,10848,5314,5534,10718,130,150,1485.24,7.3,-0.0454395,53.5303,10902.0
879,2011,DN36 5,DN36 5,Total,8255,4030,4225,8147,108,139,8068.6,1.0,-0.0334936,53.493,8298.0
880,2011,DN37 0,DN37 0,Total,7975,3831,4144,7741,234,138,6256.59,1.3,-0.11079,53.5151,7928.0
881,2011,DN37 7,DN37 7,Total,3542,1764,1778,3516,26,52,2459.24,1.4,-0.164057,53.5546,3526.0
882,2011,DN37 8,DN37 8,Total,400,197,203,370,30,6,3249.68,0.1,-0.227029,53.5773,416.0
883,2011,DN37 9,DN37 9,Total,9828,4826,5002,9793,35,84,491.83,20.0,-0.126902,53.5701,9837.0
884,2011,DN38 6,DN38 6,Total,3023,1467,1556,3008,15,53,5491.96,0.6,-0.39724,53.5603,2886.0
885,2011,DN39 6,DN39 6,Total,2846,1389,1457,2846,0,33,6101.62,0.5,-0.329646,53.6171,2785.0
886,2011,DN40 1,DN40 1,Total,5650,2715,2935,5562,88,35,1367.68,4.1,-0.208155,53.6136,5413.0
887,2011,DN40 2,DN40 2,Total,3992,1995,1997,3992,0,25,306.26,13.0,-0.212061,53.6199,4200.0
888,2011,DN40 3,DN40 3,Total,2657,1323,1334,2657,0,23,4276.23,0.6,-0.259578,53.6333,2621.0
889,2011,DN41 7,DN41 7,Total,2940,1456,1484,2936,4,55,1136.26,2.6,-0.167721,53.5806,2944.0
890,2011,DN41 8,DN41 8,Total,3326,1611,1715,3286,40,57,4172.84,0.8,-0.213338,53.5874,3335.0
891,2011,DT10 1,DT10 1,Total,6104,2989,3115,6058,46,120,3395.5,1.8,-2.30492,50.9462,6104.0
892,2011,DT10 2,DT10 2,Total,5737,2837,2900,5689,48,113,8271.47,0.7,-2.35876,50.9301,5797.0
893,2011,DT11 0,DT11 0,Total,7206,3627,3579,6409,797,188,12782.51,0.6,-2.25306,50.8479,7151.0
894,2011,DT11 7,DT11 7,Total,10325,5157,5168,10176,149,153,847.01,12.2,-2.16044,50.8615,10288.0
895,2011,DT11 8,DT11 8,Total,7905,4184,3721,6760,1145,202,11969.6,0.7,-2.16199,50.8977,7799.0
896,2011,DT11 9,DT11 9,Total,4720,2337,2383,4694,26,99,7516.35,0.6,-2.15192,50.8256,4884.0
897,2011,DY10 1,DY10 1,Total,7077,3560,3517,6997,80,75,327.49,21.6,-2.24496,52.3836,7143.0
898,2011,DY10 2,DY10 2,Total,11110,5498,5612,11010,100,92,335.43,33.1,-2.2424,52.3941,11046.0
899,2011,DY10 3,DY10 3,Total,10247,4899,5348,10124,123,106,2031.19,5.0,-2.22149,52.3974,10240.0
900,2011,DY10 4,DY10 4,Total,7380,3757,3623,7149,231,133,3914.59,1.9,-2.20713,52.3684,7241.0
901,2011,DY11 5,DY11 5,Total,9960,4862,5098,9826,134,96,1856.54,5.4,-2.26332,52.4036,10261.0
902,2011,DY11 6,DY11 6,Total,12434,6130,6304,12307,127,114,337.24,36.9,-2.26389,52.386,12631.0
903,2011,DY11 7,DY11 7,Total,7683,3853,3830,7650,33,71,755.07,10.2,-2.25438,52.3635,7419.0
904,2011,DY12 1,DY12 1,Total,4960,2459,2501,4959,1,84,2424.76,2.0,-2.30518,52.3938,4938.0
905,2011,DY12 2,DY12 2,Total,5976,2965,3011,5932,44,110,2761.89,2.2,-2.32277,52.3709,5947.0
906,2011,DY12 3,DY12 3,Total,1369,705,664,1302,67,7,4369.68,0.3,-2.37783,52.4087,1174.0
907,2011,DY13 0,DY13 0,Total,6755,3291,3464,6671,84,63,1837.02,3.7,-2.29416,52.3266,6780.0
908,2011,DY13 8,DY13 8,Total,8832,4275,4557,8736,96,67,557.89,15.8,-2.28479,52.3461,8773.0
909,2011,DY13 9,DY13 9,Total,6622,3284,3338,6603,19,71,2007.22,3.3,-2.26588,52.3353,6781.0
910,2011,DY14 0,DY14 0,Total,1775,909,866,1742,33,38,5726.65,0.3,-2.51723,52.3893,1596.0
911,2011,DY14 8,DY14 8,Total,3843,1936,1907,3792,51,67,5469.46,0.7,-2.4733,52.3988,3706.0
912,2011,DY14 9,DY14 9,Total,2911,1434,1477,2891,20,45,4195.62,0.7,-2.39791,52.3586,2933.0
913,2011,EC1A 4,EC1A 4,Total,143,53,90,143,0,8,0.38,376.3,-0.0992515,51.519,270.0
914,2011,EC1A 7,EC1A 7,Total,393,237,156,363,30,2,30.64,12.8,-0.0994929,51.518,337.0
915,2011,EC1A 9,EC1A 9,Total,358,217,141,338,20,2,8.62,41.5,-0.102364,51.519,255.0
916,2011,EC1M 3,EC1M 3,Total,428,225,203,418,10,1,3.19,134.2,-0.107446,51.5211,208.0
917,2011,EC1M 5,EC1M 5,Total,1105,628,477,880,225,5,13.45,82.2,-0.104083,51.5218,897.0
918,2011,EC1M 6,EC1M 6,Total,753,388,365,292,461,6,6.95,108.3,-0.101728,51.5205,508.0
919,2011,EC1M 7,EC1M 7,Total,187,85,102,187,0,0,1.28,146.1,-0.100288,51.5229,370.0
920,2011,EC1N 7,EC1N 7,Total,2011,1047,964,1978,33,7,12.52,160.6,-0.110741,51.5208,1855.0
921,2011,EC1N 8,EC1N 8,Total,639,350,289,571,68,12,8.33,76.7,-0.10875,51.5206,776.0
922,2011,EC1R 0,EC1R 0,Total,1225,628,597,1225,0,9,13.64,89.8,-0.106819,51.5243,1179.0
923,2011,EC1R 1,EC1R 1,Total,1239,662,577,1030,209,13,10.27,120.6,-0.10909,51.5282,1248.0
924,2011,EC1R 3,EC1R 3,Total,298,139,159,298,0,4,3.95,75.4,-0.109384,51.5236,337.0
925,2011,EC1R 4,EC1R 4,Total,1422,745,677,1422,0,14,11.06,128.6,-0.110165,51.5252,1580.0
926,2011,EC1R 5,EC1R 5,Total,701,390,311,701,0,4,7.21,97.2,-0.110608,51.5225,547.0
927,2011,EC1V 0,EC1V 0,Total,2106,1068,1038,2106,0,20,11.47,183.6,-0.102368,51.5249,2114.0
928,2011,EC1V 1,EC1V 1,Total,223,106,117,223,0,1,1.49,149.7,-0.09886,51.5294,268.0
929,2011,EC1V 2,EC1V 2,Total,121,77,44,121,0,0,2.72,44.5,-0.0967989,51.5282,400.0
930,2011,EC1V 3,EC1V 3,Total,3194,1608,1586,2539,655,35,18.48,172.8,-0.0978897,51.5257,2708.0
931,2011,EC1V 4,EC1V 4,Total,1342,701,641,1208,134,10,5.95,225.5,-0.104245,51.5255,1660.0
932,2011,EC1V 7,EC1V 7,Total,2333,1228,1105,2324,9,25,16.21,143.9,-0.103568,51.5274,2270.0
933,2011,EC1V 8,EC1V 8,Total,1711,860,851,1710,1,28,10.31,166.0,-0.0979222,51.5276,1636.0
934,2011,EC1V 9,EC1V 9,Total,1735,865,870,1680,55,19,10.21,169.9,-0.0937348,51.5253,2009.0
935,2011,EC1Y 0,EC1Y 0,Total,1216,603,613,1204,12,6,5.34,227.7,-0.0977774,51.5232,1252.0
936,2011,EC1Y 2,EC1Y 2,Total,204,139,65,204,0,0,4.25,48.0,-0.0884851,51.5234,143.0
937,2011,EC1Y 4,EC1Y 4,Total,325,157,168,149,176,2,12.92,25.2,-0.0910916,51.5209,176.0
938,2011,EC1Y 8,EC1Y 8,Total,2022,1067,955,1898,124,13,10.15,199.2,-0.0943161,51.5235,2289.0
939,2011,EC2A 3,EC2A 3,Total,483,302,181,483,0,1,4.35,111.0,-0.0862586,51.5248,749.0
940,2011,EC2A 4,EC2A 4,Total,746,433,313,746,0,0,20.58,36.2,-0.086297,51.5238,696.0
941,2011,EC2Y 8,EC2Y 8,Total,3249,1727,1522,3165,84,47,31.18,104.2,-0.0998955,51.5213,3131.0
942,2011,EC3R 8,EC3R 8,Total,227,149,78,227,0,5,33.92,6.7,-0.0892884,51.5124,64.0
943,2011,EC4A 1,EC4A 1,Total,151,90,61,151,0,0,7.86,19.2,-0.1102,51.5165,159.0
944,2011,EC4V 3,EC4V 3,Total,319,180,139,319,0,1,23.19,13.8,-0.0975407,51.5115,296.0
945,2011,EC4V 5,EC4V 5,Total,276,177,99,235,41,3,26.72,10.3,-0.10163,51.5133,129.0
946,2011,EC4Y 7,EC4Y 7,Total,320,196,124,320,0,5,23.96,13.4,-0.110003,51.5134,67.0
947,2011,EN10 6,EN10 6,Total,10904,5245,5659,10815,89,103,611.03,17.8,-0.0196702,51.7344,10769.0
948,2011,EN10 7,EN10 7,Total,6132,3015,3117,6097,35,115,533.55,11.5,-0.0228307,51.7482,6434.0
949,2011,EN11 0,EN11 0,Total,6488,3184,3304,6487,1,38,378.56,17.1,-0.00108046,51.7658,6430.0
950,2011,EN11 8,EN11 8,Total,6633,3269,3364,6610,23,53,707.36,9.4,-0.0139026,51.7598,6370.0
951,2011,EN11 9,EN11 9,Total,8330,4062,4268,8259,71,102,171.78,48.5,-0.0120213,51.7715,8678.0
952,2011,EX10 0,EX10 0,Total,4638,2239,2399,4514,124,185,7014.31,0.7,-3.26684,50.7029,4326.0
953,2011,EX10 8,EX10 8,Total,3420,1494,1926,3215,205,54,383.86,8.9,-3.24055,50.6816,3481.0
954,2011,EX10 9,EX10 9,Total,9149,4231,4918,8996,153,113,1019.79,9.0,-3.23615,50.6954,8971.0
955,2011,EX11 1,EX11 1,Total,7795,3733,4062,7730,65,146,3213.48,2.4,-3.28861,50.7472,7999.0
956,2011,EX12 2,EX12 2,Total,7096,3260,3836,6902,194,66,475.86,14.9,-3.07299,50.7097,7093.0
957,2011,EX12 3,EX12 3,Total,1824,896,928,1823,1,29,2086.95,0.9,-3.10705,50.6983,1788.0
958,2011,EX12 4,EX12 4,Total,496,234,262,496,0,5,1235.4,0.4,-3.04916,50.7151,425.0
959,2011,EX13 5,EX13 5,Total,6997,3341,3656,6879,118,70,3270.59,2.1,-2.98571,50.7824,7080.0
960,2011,EX13 7,EX13 7,Total,3789,1862,1927,3781,8,64,7087.01,0.5,-3.02992,50.7985,3888.0
961,2011,EX13 8,EX13 8,Total,543,260,283,521,22,7,858.41,0.6,-3.01791,50.7512,754.0
962,2011,EX14 1,EX14 1,Total,5958,2777,3181,5895,63,64,579.72,10.3,-3.19273,50.7983,5378.0
963,2011,EX14 2,EX14 2,Total,5525,2624,2901,5493,32,61,716.92,7.7,-3.19278,50.7932,5724.0
964,2011,EX14 3,EX14 3,Total,3799,1872,1927,3776,23,61,5443.96,0.7,-3.25827,50.8001,4103.0
965,2011,EX14 4,EX14 4,Total,2461,1224,1237,2420,41,30,5243.01,0.5,-3.2084,50.8467,2549.0
966,2011,EX14 9,EX14 9,Total,2944,1455,1489,2942,2,54,9419.11,0.3,-3.12146,50.8305,3056.0
967,2011,EX15 1,EX15 1,Total,8766,4288,4478,8599,167,93,4653.58,1.9,-3.39696,50.8562,8808.0
968,2011,EX15 2,EX15 2,Total,5881,2891,2990,5851,30,102,6156.81,1.0,-3.34917,50.8661,5950.0
969,2011,EX15 3,EX15 3,Total,6666,3292,3374,6655,11,102,8445.02,0.8,-3.2797,50.9087,6285.0
970,2011,EX16 4,EX16 4,Total,6179,3012,3167,5956,223,98,3908.16,1.6,-3.46669,50.902,5810.0
971,2011,EX16 5,EX16 5,Total,4920,2397,2523,4895,25,32,1479.85,3.3,-3.49682,50.9027,4950.0
972,2011,EX16 6,EX16 6,Total,9691,4710,4981,9612,79,87,265.91,36.4,-3.48116,50.9084,9719.0
973,2011,EX16 7,EX16 7,Total,4384,2170,2214,4364,20,85,7181.14,0.6,-3.39939,50.934,4546.0
974,2011,EX16 8,EX16 8,Total,3909,1957,1952,3885,24,66,14507.4,0.3,-3.61037,50.9063,3900.0
975,2011,EX16 9,EX16 9,Total,3357,1632,1725,3293,64,69,11384.25,0.3,-3.5097,50.9805,3309.0
976,2011,EX17 1,EX17 1,Total,2185,1087,1098,2185,0,31,1816.55,1.2,-3.63235,50.7944,2115.0
977,2011,EX17 2,EX17 2,Total,2176,1011,1165,2124,52,23,63.53,34.3,-3.6618,50.7927,2290.0
978,2011,EX17 3,EX17 3,Total,4362,2180,2182,4263,99,63,1935.21,2.3,-3.65776,50.7871,4291.0
979,2011,EX17 4,EX17 4,Total,3273,1628,1645,3260,13,68,10987.7,0.3,-3.66073,50.8439,3321.0
980,2011,EX17 5,EX17 5,Total,3320,1647,1673,3294,26,57,7788.38,0.4,-3.75725,50.7879,3211.0
981,2011,EX17 6,EX17 6,Total,4223,2044,2179,4204,19,45,8586.83,0.5,-3.79198,50.8309,4262.0
982,2011,EX18 7,EX18 7,Total,3117,1531,1586,3091,26,64,12692.91,0.2,-3.88652,50.9016,2958.0
983,2011,EX19 8,EX19 8,Total,3525,1740,1785,3501,24,50,9227.99,0.4,-3.99973,50.8761,3611.0
984,2011,EX20 1,EX20 1,Total,7898,3853,4045,7783,115,73,2256.99,3.5,-3.99513,50.74,7912.0
985,2011,EX20 2,EX20 2,Total,4542,2271,2271,4518,24,74,11636.6,0.4,-3.91205,50.7639,4601.0
986,2011,EX20 3,EX20 3,Total,4457,2205,2252,4354,103,83,16068.71,0.3,-4.07016,50.8084,4477.0
987,2011,EX20 4,EX20 4,Total,3069,1521,1548,2997,72,45,17791.66,0.2,-4.13441,50.6806,3135.0
988,2011,EX21 5,EX21 5,Total,4620,2279,2341,4467,153,71,18937.03,0.2,-4.20924,50.8033,4405.0
989,2011,EX22 6,EX22 6,Total,5939,2912,3027,5786,153,54,14647.67,0.4,-4.37974,50.7902,5833.0
990,2011,EX22 7,EX22 7,Total,4806,2388,2418,4753,53,77,19170.82,0.3,-4.35395,50.8659,4820.0
991,2011,EX23 0,EX23 0,Total,3460,1660,1800,3345,115,57,7522.03,0.5,-4.55951,50.7732,3520.0
992,2011,EX23 8,EX23 8,Total,7401,3564,3837,7276,125,101,636.89,11.6,-4.53947,50.8293,7239.0
993,2011,EX23 9,EX23 9,Total,4843,2405,2438,4758,85,82,10118.02,0.5,-4.50774,50.8579,4861.0
994,2011,EX24 6,EX24 6,Total,3789,1799,1990,3748,41,85,5470.77,0.7,-3.0873,50.7375,3728.0
995,2011,EX31 1,EX31 1,Total,3560,1740,1820,3553,7,46,142.02,25.1,-4.06367,51.0833,3589.0
996,2011,EX31 2,EX31 2,Total,6325,3019,3306,6216,109,76,754.94,8.4,-4.08735,51.0733,6208.0
997,2011,EX31 3,EX31 3,Total,8170,3915,4255,8166,4,104,6429.46,1.3,-4.10126,51.0573,8199.0
998,2011,EX31 4,EX31 4,Total,7420,3857,3563,6792,628,154,18727.16,0.4,-4.01813,51.13,7090.0
999,2011,EX32 0,EX32 0,Total,5336,2612,2724,5214,122,79,8738.37,0.6,-3.99328,51.0559,4915.0
1000,2011,EX32 7,EX32 7,Total,6937,3372,3565,6860,77,67,4596.24,1.5,-4.0121,51.0858,6846.0
1001,2011,EX32 8,EX32 8,Total,6266,3003,3263,6255,11,49,118.53,52.9,-4.04654,51.0777,6770.0
1002,2011,EX32 9,EX32 9,Total,5239,2511,2728,5154,85,89,183.28,28.6,-4.04672,51.072,5365.0
1003,2011,EX33 1,EX33 1,Total,5362,2596,2766,5335,27,90,4054.57,1.3,-4.18259,51.1179,5251.0
1004,2011,EX33 2,EX33 2,Total,4862,2334,2528,4766,96,83,1868.88,2.6,-4.14801,51.1066,5008.0
1005,2011,EX34 0,EX34 0,Total,2687,1294,1393,2672,15,27,1485.46,1.8,-4.02673,51.1992,2864.0
1006,2011,EX34 7,EX34 7,Total,1637,820,817,1601,36,15,1543.1,1.1,-4.18829,51.1794,1655.0
1007,2011,EX34 8,EX34 8,Total,6457,3118,3339,6324,133,76,3152.76,2.0,-4.12709,51.1983,6694.0
1008,2011,EX34 9,EX34 9,Total,6525,3189,3336,6231,294,56,2790.49,2.3,-4.111,51.2071,6107.0
1009,2011,EX35 6,EX35 6,Total,1647,791,856,1450,197,21,6857.1,0.2,-3.82933,51.2247,1677.0
1010,2011,EX36 3,EX36 3,Total,3920,1907,2013,3806,114,58,16244.99,0.2,-3.79935,51.0339,3380.0
1011,2011,EX36 4,EX36 4,Total,4557,2196,2361,4531,26,69,8065.63,0.6,-3.79891,51.0009,5160.0
1012,2011,EX37 9,EX37 9,Total,3362,1655,1707,3334,28,62,11845.64,0.3,-3.95527,50.9793,3562.0
1013,2011,EX38 7,EX38 7,Total,4488,2135,2353,4422,66,56,4234.66,1.1,-4.12394,50.9566,4284.0
1014,2011,EX38 8,EX38 8,Total,3644,1785,1859,3585,59,33,5790.12,0.6,-4.16953,50.9372,3980.0
1015,2011,EX39 1,EX39 1,Total,9389,4510,4879,9258,131,91,851.1,11.0,-4.21398,51.0427,9327.0
1016,2011,EX39 2,EX39 2,Total,3760,1818,1942,3697,63,33,115.39,32.6,-4.20893,51.021,3872.0
1017,2011,EX39 3,EX39 3,Total,9009,4373,4636,8787,222,104,689.98,13.1,-4.21914,51.0194,9083.0
1018,2011,EX39 4,EX39 4,Total,6870,3355,3515,6787,83,74,4021.08,1.7,-4.18356,51.0233,6859.0
1019,2011,EX39 5,EX39 5,Total,6224,3054,3170,6158,66,89,12769.53,0.5,-4.29111,50.9816,6222.0
1020,2011,EX39 6,EX39 6,Total,1911,960,951,1903,8,35,7728.51,0.2,-4.48754,50.9839,1814.0
1021,2011,GL10 2,GL10 2,Total,6858,3404,3454,6555,303,87,409.45,16.7,-2.27979,51.7471,6997.0
1022,2011,GL10 3,GL10 3,Total,7095,3501,3594,7045,50,111,5536.12,1.3,-2.28544,51.743,6783.0
1023,2011,GL11 4,GL11 4,Total,6187,3054,3133,6095,92,74,397.05,15.6,-2.35315,51.6826,6022.0
1024,2011,GL11 5,GL11 5,Total,8033,3988,4045,8030,3,135,2474.59,3.2,-2.35073,51.6975,8317.0
1025,2011,GL11 6,GL11 6,Total,3919,1907,2012,3873,46,85,2454.74,1.6,-2.37521,51.6921,3846.0
1026,2011,GL12 7,GL12 7,Total,6328,3097,3231,6267,61,143,3593.22,1.8,-2.34867,51.638,6395.0
1027,2011,GL12 8,GL12 8,Total,8717,4504,4213,7903,814,166,6461.93,1.3,-2.41431,51.6175,8852.0
1028,2011,GL13 9,GL13 9,Total,5863,2917,2946,5824,39,88,7151.4,0.8,-2.45372,51.693,5699.0
1029,2011,GL14 1,GL14 1,Total,3804,1920,1884,3666,138,83,5870.6,0.6,-2.43374,51.8131,3340.0
1030,2011,GL14 2,GL14 2,Total,8039,3920,4119,7999,40,48,2577.9,3.1,-2.49998,51.8223,7666.0
1031,2011,GL14 3,GL14 3,Total,3879,1956,1923,3861,18,27,740.13,5.2,-2.49795,51.815,4235.0
1032,2011,GL15 4,GL15 4,Total,4988,2452,2536,4930,58,57,3520.2,1.4,-2.52276,51.7548,5444.0
1033,2011,GL15 5,GL15 5,Total,8776,4260,4516,8702,74,88,2089.89,4.2,-2.52829,51.7254,8479.0
1034,2011,GL15 6,GL15 6,Total,6979,3446,3533,6978,1,103,5742.7,1.2,-2.59428,51.729,6836.0
1035,2011,GL16 7,GL16 7,Total,7116,3500,3616,7104,12,78,2538.76,2.8,-2.60534,51.8015,7097.0
1036,2011,GL16 8,GL16 8,Total,6265,3047,3218,6168,97,78,2916.22,2.1,-2.61989,51.7896,6184.0
1037,2011,GL17 0,GL17 0,Total,4537,2212,2325,4385,152,51,3064.98,1.5,-2.4795,51.8655,4804.0
1038,2011,GL17 9,GL17 9,Total,6643,3324,3319,6594,49,54,1888.35,3.5,-2.54726,51.8481,6743.0
1039,2011,GL18 1,GL18 1,Total,5999,2907,3092,5925,74,92,4556.44,1.3,-2.40782,51.9308,6428.0
1040,2011,GL18 2,GL18 2,Total,1494,750,744,1470,24,36,3843.47,0.4,-2.43748,51.9789,1318.0
1041,2011,GL19 3,GL19 3,Total,6644,3227,3417,5742,902,151,8016.07,0.8,-2.33195,51.9301,6013.0
1042,2011,GL19 4,GL19 4,Total,3159,1579,1580,3135,24,94,7001.32,0.5,-2.22417,51.9489,3203.0
1043,2011,GL20 5,GL20 5,Total,7139,3526,3613,7118,21,68,381.32,18.7,-2.15383,51.9916,7178.0
1044,2011,GL20 6,GL20 6,Total,2835,1405,1430,2654,181,68,4308.55,0.7,-2.16959,52.0242,2776.0
1045,2011,GL20 7,GL20 7,Total,7412,3620,3792,7410,2,120,4030.04,1.8,-2.11234,52.0085,7970.0
1046,2011,GL20 8,GL20 8,Total,10847,5504,5343,10728,119,137,3925.93,2.8,-2.10843,52.0011,10430.0
1047,2011,GL50 1,GL50 1,Total,1007,562,445,956,51,14,29.13,34.6,-2.0776,51.8985,1307.0
1048,2011,GL50 2,GL50 2,Total,8317,4152,4165,7777,540,178,160.88,51.7,-2.0861,51.893,7796.0
1049,2011,GL50 3,GL50 3,Total,4247,1875,2372,3394,853,29,68.09,62.4,-2.08213,51.9017,4782.0
1050,2011,GL50 4,GL50 4,Total,8925,4328,4597,8770,155,108,346.26,25.8,-2.07875,51.9095,8802.0
1051,2011,GL51 0,GL51 0,Total,11984,5818,6166,11861,123,79,1463.43,8.2,-2.118,51.9079,11945.0
1052,2011,GL51 3,GL51 3,Total,10060,4839,5221,10042,18,146,226.53,44.4,-2.10463,51.8862,10275.0
1053,2011,GL51 4,GL51 4,Total,2413,1149,1264,2337,76,38,1359.32,1.8,-2.1134,51.8712,2300.0
1054,2011,GL51 6,GL51 6,Total,7961,3897,4064,7589,372,148,423.77,18.8,-2.11754,51.8926,8035.0
1055,2011,GL51 7,GL51 7,Total,6501,3182,3319,6409,92,50,105.02,61.9,-2.10879,51.9023,6874.0
1056,2011,GL51 8,GL51 8,Total,6893,3526,3367,6802,91,68,162.84,42.3,-2.09668,51.9036,6104.0
1057,2011,GL51 9,GL51 9,Total,5708,2773,2935,5543,165,54,1406.46,4.1,-2.09562,51.915,5931.0
1058,2011,GL52 2,GL52 2,Total,4640,2427,2213,4619,21,37,84.25,55.1,-2.06987,51.9033,5171.0
1059,2011,GL52 3,GL52 3,Total,5567,2615,2952,5242,325,116,1560.8,3.6,-2.05571,51.9162,5401.0
1060,2011,GL52 5,GL52 5,Total,8768,4250,4518,8751,17,94,1411.98,6.2,-2.0504,51.9065,8380.0
1061,2011,GL52 6,GL52 6,Total,9425,4688,4737,9304,121,186,695.75,13.5,-2.05814,51.8947,9187.0
1062,2011,GL52 7,GL52 7,Total,1538,731,807,1538,0,34,1062.85,1.4,-2.08781,51.9475,1544.0
1063,2011,GL52 8,GL52 8,Total,9509,4505,5004,9463,46,129,719.4,13.2,-2.06423,51.9406,9426.0
1064,2011,GL52 9,GL52 9,Total,3818,1843,1975,3818,0,98,1610.83,2.4,-2.05263,51.9462,3853.0
1065,2011,GL53 0,GL53 0,Total,4129,1984,2145,4095,34,97,181.59,22.7,-2.08278,51.8827,4522.0
1066,2011,GL53 7,GL53 7,Total,6185,3099,3086,5688,497,152,194.07,31.9,-2.07374,51.8921,5719.0
1067,2011,GL53 8,GL53 8,Total,5344,2530,2814,5226,118,108,477.48,11.2,-2.05315,51.8833,5180.0
1068,2011,GL53 9,GL53 9,Total,4097,1941,2156,3946,151,108,3503.29,1.2,-2.06447,51.8669,4547.0
1069,2011,GL54 1,GL54 1,Total,2982,1414,1568,2914,68,47,4209.62,0.7,-1.74124,51.9274,2894.0
1070,2011,GL54 2,GL54 2,Total,5513,2650,2863,5459,54,121,4556.8,1.2,-1.78214,51.8865,5643.0
1071,2011,GL54 3,GL54 3,Total,3687,1763,1924,3635,52,113,13152.04,0.3,-1.85674,51.8445,3619.0
1072,2011,GL54 4,GL54 4,Total,2905,1467,1438,2900,5,89,9173.26,0.3,-1.96223,51.855,2930.0
1073,2011,GL54 5,GL54 5,Total,7059,3439,3620,7049,10,155,14726.16,0.5,-1.96431,51.9479,7164.0
1074,2011,GL55 6,GL55 6,Total,5422,2570,2852,5335,87,99,7805.66,0.7,-1.77086,52.0625,5175.0
1075,2011,GL56 0,GL56 0,Total,5159,2444,2715,5113,46,116,6935.34,0.7,-1.68909,51.977,5125.0
1076,2011,GL56 9,GL56 9,Total,3244,1555,1689,3233,11,58,6156.83,0.5,-1.72581,52.0098,3440.0
1077,2011,GU10 1,GU10 1,Total,4581,2227,2354,4567,14,83,1499.46,3.1,-0.744064,51.2231,4941.0
1078,2011,GU10 2,GU10 2,Total,2887,1431,1456,2757,130,120,2482.55,1.2,-0.77057,51.1626,2928.0
1079,2011,GU10 3,GU10 3,Total,4437,2257,2180,4179,258,150,1229.17,3.6,-0.792399,51.1895,4220.0
1080,2011,GU10 4,GU10 4,Total,6553,3238,3315,6513,40,181,1342.19,4.9,-0.8179,51.1889,6529.0
1081,2011,GU10 5,GU10 5,Total,3780,1767,2013,3599,181,115,3344.03,1.1,-0.849714,51.2206,3966.0
1082,2011,GU11 1,GU11 1,Total,6271,3143,3128,6238,33,57,806.88,7.8,-0.765345,51.2493,6880.0
1083,2011,GU11 2,GU11 2,Total,4626,2790,1836,3364,1262,88,883.34,5.2,-0.752023,51.2617,4361.0
1084,2011,GU11 3,GU11 3,Total,12395,6048,6347,12191,204,129,235.08,52.7,-0.765574,51.243,12654.0
1085,2011,GU12 4,GU12 4,Total,14535,7237,7298,14529,6,98,285.46,50.9,-0.747711,51.2458,14011.0
1086,2011,GU12 5,GU12 5,Total,7763,3848,3915,7706,57,74,547.84,14.2,-0.726387,51.265,7817.0
1087,2011,GU12 6,GU12 6,Total,9181,4520,4661,9153,28,76,500.51,18.3,-0.721111,51.2469,9110.0
1088,2011,GU14 0,GU14 0,Total,8039,3959,4080,8030,9,101,304.6,26.4,-0.774225,51.2888,7878.0
1089,2011,GU14 6,GU14 6,Total,9418,4722,4696,9153,265,100,421.58,22.3,-0.748579,51.2792,9129.0
1090,2011,GU14 7,GU14 7,Total,6129,3022,3107,6104,25,96,204.04,30.0,-0.752726,51.289,6441.0
1091,2011,GU14 8,GU14 8,Total,16241,7928,8313,16230,11,195,412.58,39.4,-0.75957,51.3007,16030.0
1092,2011,GU14 9,GU14 9,Total,15167,7454,7713,15167,0,193,323.57,46.9,-0.779583,51.3022,15696.0
1093,2011,GU15 1,GU15 1,Total,9935,4864,5071,9852,83,241,401.61,24.7,-0.723226,51.3333,9947.0
1094,2011,GU15 2,GU15 2,Total,9561,4736,4825,9392,169,207,451.08,21.2,-0.747811,51.3294,9937.0
1095,2011,GU15 3,GU15 3,Total,6729,3374,3355,6606,123,116,268.34,25.1,-0.75437,51.3347,6615.0
1096,2011,GU15 4,GU15 4,Total,8553,4493,4060,7711,842,102,715.4,12.0,-0.761101,51.3477,8509.0
1097,2011,GU16 6,GU16 6,Total,10274,5164,5110,9981,293,170,1196.99,8.6,-0.723924,51.3038,10094.0
1098,2011,GU16 7,GU16 7,Total,2067,1016,1051,1963,104,22,96.62,21.4,-0.749788,51.3176,2203.0
1099,2011,GU16 8,GU16 8,Total,7653,3768,3885,7653,0,141,206.15,37.1,-0.734308,51.3194,7301.0
1100,2011,GU16 9,GU16 9,Total,3773,1866,1907,3750,23,105,103.59,36.4,-0.725175,51.3182,3976.0
1101,2011,GU17 0,GU17 0,Total,7195,3588,3607,7195,0,80,266.6,27.0,-0.787601,51.3337,7252.0
1102,2011,GU17 9,GU17 9,Total,3906,1965,1941,3692,214,43,1154.45,3.4,-0.786206,51.3231,3632.0
1103,2011,GU18 5,GU18 5,Total,6791,3307,3484,6756,35,147,419.06,16.2,-0.66317,51.3475,6891.0
1104,2011,GU19 5,GU19 5,Total,5592,2791,2801,5508,84,89,865.13,6.5,-0.689643,51.3591,5618.0
1105,2011,GU20 6,GU20 6,Total,4392,2185,2207,4329,63,150,955.33,4.6,-0.657061,51.3677,4329.0
1106,2011,GU21 2,GU21 2,Total,11651,5780,5871,11563,88,168,480.52,24.2,-0.614673,51.3177,11649.0
1107,2011,GU21 3,GU21 3,Total,11100,5392,5708,11096,4,123,197.83,56.1,-0.583089,51.319,11044.0
1108,2011,GU21 4,GU21 4,Total,9883,4849,5034,9750,133,258,735.14,13.4,-0.566267,51.3253,9768.0
1109,2011,GU21 5,GU21 5,Total,8575,4384,4191,8564,11,90,228.15,37.6,-0.543288,51.3264,9150.0
1110,2011,GU21 6,GU21 6,Total,2317,1228,1089,2312,5,21,63.99,36.2,-0.561468,51.3186,2264.0
1111,2011,GU21 7,GU21 7,Total,2064,1012,1052,2024,40,34,68.37,30.2,-0.585178,51.3129,2169.0
1112,2011,GU21 8,GU21 8,Total,4148,2043,2105,4148,0,58,99.49,41.7,-0.59639,51.3132,4199.0
1113,2011,GU22 0,GU22 0,Total,6979,3399,3580,6909,70,191,1174.72,5.9,-0.57427,51.3052,6261.0
1114,2011,GU22 7,GU22 7,Total,8866,4475,4391,8684,182,165,367.09,24.2,-0.556236,51.3153,8950.0
1115,2011,GU22 8,GU22 8,Total,9655,4817,4838,9521,134,179,700.85,13.8,-0.528168,51.3211,9924.0
1116,2011,GU22 9,GU22 9,Total,7900,3988,3912,7823,77,109,540.65,14.6,-0.553297,51.3044,7940.0
1117,2011,GU23 6,GU23 6,Total,3842,1885,1957,3799,43,70,2183.73,1.8,-0.499613,51.3008,3673.0
1118,2011,GU23 7,GU23 7,Total,3027,1389,1638,2753,274,73,1099.67,2.8,-0.530673,51.2922,3191.0
1119,2011,GU24 0,GU24 0,Total,4963,2690,2273,4456,507,79,2139.06,2.3,-0.644544,51.2999,4951.0
1120,2011,GU24 8,GU24 8,Total,4224,2059,2165,4162,62,104,2542.97,1.7,-0.602058,51.3514,4260.0
1121,2011,GU24 9,GU24 9,Total,8658,4578,4080,7948,710,186,1818.16,4.8,-0.634307,51.3302,8350.0
1122,2011,GU25 4,GU25 4,Total,5448,2659,2789,5310,138,188,1038.64,5.2,-0.570556,51.4013,5712.0
1123,2011,GU26 6,GU26 6,Total,7475,3583,3892,6913,562,182,1479.59,5.1,-0.746127,51.1102,7355.0
1124,2011,GU27 1,GU27 1,Total,6763,3233,3530,6612,151,158,865.23,7.8,-0.729755,51.0906,6915.0
1125,2011,GU27 2,GU27 2,Total,5039,2398,2641,4999,40,142,585.07,8.6,-0.708974,51.092,4391.0
1126,2011,GU27 3,GU27 3,Total,5923,2913,3010,5663,260,210,4742.76,1.2,-0.722964,51.0695,6504.0
1127,2011,GU28 0,GU28 0,Total,3772,1778,1994,3573,199,99,5287.08,0.7,-0.626357,50.9735,3969.0
1128,2011,GU28 9,GU28 9,Total,2878,1410,1468,2874,4,81,6172.41,0.5,-0.634724,51.0159,2812.0
1129,2011,GU29 0,GU29 0,Total,3206,1539,1667,3175,31,125,8110.19,0.4,-0.75473,50.9839,2845.0
1130,2011,GU29 9,GU29 9,Total,5888,2728,3160,5824,64,86,410.06,14.4,-0.741782,50.9849,6260.0
1131,2011,GU30 7,GU30 7,Total,9081,4410,4671,8974,107,273,4617.34,2.0,-0.80394,51.0758,9268.0
1132,2011,GU31 4,GU31 4,Total,7643,3613,4030,7602,41,164,590.36,12.9,-0.929272,51.0036,7484.0
1133,2011,GU31 5,GU31 5,Total,3580,1770,1810,3562,18,154,7997.69,0.4,-0.884374,50.9908,3542.0
1134,2011,GU32 1,GU32 1,Total,3312,1633,1679,3248,64,135,7219.99,0.5,-1.01248,51.0108,3269.0
1135,2011,GU32 2,GU32 2,Total,3833,1823,2010,3387,446,119,1071.11,3.6,-0.935211,51.0131,3918.0
1136,2011,GU32 3,GU32 3,Total,4824,2307,2517,4788,36,56,359.76,13.4,-0.944389,51.0041,4927.0
1137,2011,GU33 6,GU33 6,Total,1935,958,977,1907,28,61,3257.89,0.6,-0.904715,51.0632,1938.0
1138,2011,GU33 7,GU33 7,Total,6507,3040,3467,6151,356,125,1502.37,4.3,-0.886975,51.0397,6465.0
1139,2011,GU34 1,GU34 1,Total,6437,3064,3373,6399,38,105,1313.79,4.9,-0.98023,51.1464,6107.0
1140,2011,GU34 2,GU34 2,Total,10206,5021,5185,10045,161,130,382.04,26.7,-0.971596,51.1533,10448.0
1141,2011,GU34 3,GU34 3,Total,2480,1231,1249,2480,0,100,7466.17,0.3,-0.973125,51.0998,2687.0
1142,2011,GU34 4,GU34 4,Total,3912,1919,1993,3689,223,158,5165.83,0.8,-0.949201,51.1649,3867.0
1143,2011,GU34 5,GU34 5,Total,6748,3321,3427,6669,79,191,4023.4,1.7,-1.04032,51.1295,6775.0
1144,2011,GU35 0,GU35 0,Total,11209,5647,5562,10881,328,155,1432.66,7.8,-0.856106,51.1168,11146.0
1145,2011,GU35 8,GU35 8,Total,5613,2734,2879,5570,43,126,1955.02,2.9,-0.819041,51.1194,5262.0
1146,2011,GU35 9,GU35 9,Total,6246,3131,3115,6236,10,108,2506.29,2.5,-0.873091,51.1137,6272.0
1147,2011,GU46 6,GU46 6,Total,11356,5558,5798,11354,2,219,599.14,19.0,-0.824231,51.3364,11305.0
1148,2011,GU46 7,GU46 7,Total,3473,1685,1788,3473,0,66,272.44,12.7,-0.823892,51.343,3518.0
1149,2011,GU47 0,GU47 0,Total,10693,5279,5414,10671,22,176,512.71,20.9,-0.781671,51.3478,10643.0
1150,2011,GU47 8,GU47 8,Total,4389,2149,2240,4265,124,94,284.65,15.4,-0.805316,51.3505,4350.0
1151,2011,GU47 9,GU47 9,Total,3780,1863,1917,3743,37,47,177.39,21.3,-0.79551,51.3464,3867.0
1152,2011,GU51 1,GU51 1,Total,5183,2576,2607,5183,0,59,174.73,29.7,-0.853066,51.2926,5204.0
1153,2011,GU51 2,GU51 2,Total,2542,1305,1237,2542,0,53,521.54,4.9,-0.82789,51.2936,2538.0
1154,2011,GU51 3,GU51 3,Total,8538,4276,4262,8507,31,179,301.17,28.3,-0.832226,51.2815,8232.0
1155,2011,GU51 4,GU51 4,Total,4047,1889,2158,3858,189,124,275.3,14.7,-0.844699,51.284,4279.0
1156,2011,GU51 5,GU51 5,Total,3294,1618,1676,3294,0,63,435.5,7.6,-0.856213,51.276,3145.0
1157,2011,GU52 0,GU52 0,Total,2469,1222,1247,2469,0,35,52.17,47.3,-0.84797,51.2611,2420.0
1158,2011,GU52 6,GU52 6,Total,7574,3659,3915,7479,95,134,343.4,22.1,-0.838048,51.267,7203.0
1159,2011,GU52 7,GU52 7,Total,3257,1637,1620,3257,0,88,101.35,32.1,-0.838287,51.2738,3692.0
1160,2011,GU52 8,GU52 8,Total,2653,1317,1336,2653,0,55,623.08,4.3,-0.833654,51.2605,2753.0
1161,2011,HP10 0,HP10 0,Total,5261,2507,2754,5230,31,74,515.38,10.2,-0.697088,51.5947,5486.0
1162,2011,HP10 8,HP10 8,Total,5683,2770,2913,5658,25,195,695.62,8.2,-0.715221,51.6337,5665.0
1163,2011,HP10 9,HP10 9,Total,8021,3905,4116,8015,6,166,745.08,10.8,-0.716789,51.6068,8244.0
1164,2011,HP11 1,HP11 1,Total,7739,3605,4134,6997,742,152,540.62,14.3,-0.734739,51.6196,8012.0
1165,2011,HP11 2,HP11 2,Total,5766,2967,2799,5368,398,76,141.11,40.9,-0.75765,51.6296,6217.0
1166,2011,HP12 3,HP12 3,Total,12382,6365,6017,12359,23,146,232.22,53.3,-0.773762,51.6265,11913.0
1167,2011,HP12 4,HP12 4,Total,10440,5145,5295,10314,126,138,819.93,12.7,-0.784427,51.6235,10235.0
1168,2011,HP13 5,HP13 5,Total,13988,7005,6983,13596,392,235,697.42,20.1,-0.758298,51.6393,14530.0
1169,2011,HP13 6,HP13 6,Total,11272,5719,5553,11106,166,180,219.84,51.3,-0.741812,51.632,11424.0
1170,2011,HP13 7,HP13 7,Total,17799,8782,9017,17796,3,156,431.1,41.3,-0.724473,51.6278,16862.0
1171,2011,HP14 3,HP14 3,Total,9439,4673,4766,9407,32,189,4394.71,2.1,-0.851654,51.6376,9568.0
1172,2011,HP14 4,HP14 4,Total,8284,4168,4116,8003,281,268,3636.7,2.3,-0.795196,51.6619,7797.0
1173,2011,HP15 6,HP15 6,Total,8171,3960,4211,8141,30,195,1253.64,6.5,-0.718161,51.6596,8255.0
1174,2011,HP15 7,HP15 7,Total,9257,4477,4780,9183,74,190,398.75,23.2,-0.716345,51.648,9239.0
1175,2011,HP16 0,HP16 0,Total,6965,3367,3598,6891,74,223,1658.63,4.2,-0.718756,51.6964,7202.0
1176,2011,HP16 9,HP16 9,Total,4881,2371,2510,4866,15,173,3168.97,1.5,-0.718656,51.7099,4754.0
1177,2011,HP17 0,HP17 0,Total,1148,563,585,1148,0,30,1758.35,0.7,-0.811002,51.7218,954.0
1178,2011,HP17 8,HP17 8,Total,7994,3854,4140,7895,99,194,4359.29,1.8,-0.886919,51.7824,8230.0
1179,2011,HP17 9,HP17 9,Total,902,458,444,902,0,19,1306.66,0.7,-0.843519,51.7295,459.0
1180,2011,HP18 0,HP18 0,Total,6218,3280,2938,5701,517,159,8844.23,0.7,-0.91821,51.8374,6287.0
1181,2011,HP18 9,HP18 9,Total,7304,3610,3694,7268,36,193,9146.25,0.8,-1.01334,51.7927,7247.0
1182,2011,HP19 0,HP19 0,Total,2343,1157,1186,2296,47,29,127.12,18.4,-0.805744,51.8298,2343.0
1183,2011,HP19 7,HP19 7,Total,6998,3491,3507,6998,0,50,131.27,53.3,-0.836577,51.816,6645.0
1184,2011,HP19 8,HP19 8,Total,3522,1768,1754,3400,122,30,965.41,3.6,-0.829217,51.8205,3867.0
1185,2011,HP19 9,HP19 9,Total,10894,5333,5561,10824,70,109,617.04,17.7,-0.823968,51.8272,10784.0
1186,2011,HP20 1,HP20 1,Total,8042,4130,3912,7648,394,78,198.33,40.5,-0.800882,51.818,8474.0
1187,2011,HP20 2,HP20 2,Total,6866,3437,3429,6855,11,59,130.13,52.8,-0.809873,51.8214,6274.0
1188,2011,HP21 7,HP21 7,Total,9634,4835,4799,9543,91,170,239.3,40.3,-0.79662,51.81,9272.0
1189,2011,HP21 8,HP21 8,Total,13165,6488,6677,13092,73,126,243.93,54.0,-0.818816,51.8082,13103.0
1190,2011,HP21 9,HP21 9,Total,10556,5184,5372,10496,60,138,248.45,42.5,-0.80258,51.8016,11118.0
1191,2011,HP22 4,HP22 4,Total,5170,2523,2647,5120,50,140,6760.6,0.8,-0.812275,51.8541,5340.0
1192,2011,HP22 5,HP22 5,Total,13431,6526,6905,13064,367,325,5009.75,2.7,-0.750267,51.7957,13429.0
1193,2011,HP22 6,HP22 6,Total,6097,2896,3201,5959,138,110,1776.92,3.4,-0.743681,51.7646,6215.0
1194,2011,HP23 4,HP23 4,Total,6051,2929,3122,6003,48,157,2955.33,2.0,-0.673829,51.8034,6181.0
1195,2011,HP23 5,HP23 5,Total,8076,3943,4133,7888,188,199,1614.15,5.0,-0.653012,51.7976,7795.0
1196,2011,HP23 6,HP23 6,Total,3332,1589,1743,3324,8,105,1998.26,1.7,-0.65948,51.7805,3623.0
1197,2011,HP27 0,HP27 0,Total,6429,3041,3388,6293,136,143,1541.5,4.2,-0.818953,51.7146,6338.0
1198,2011,HP27 9,HP27 9,Total,5782,2842,2940,5720,62,129,2767.55,2.1,-0.843293,51.7273,6151.0
1199,2011,HU10 6,HU10 6,Total,10910,5236,5674,10825,85,121,633.52,17.2,-0.435152,53.7514,11051.0
1200,2011,HU10 7,HU10 7,Total,8147,3981,4166,8030,117,132,812.91,10.0,-0.446753,53.7461,8179.0
1201,2011,HU11 4,HU11 4,Total,8099,4003,4096,8066,33,76,10587.88,0.8,-0.210032,53.8026,8417.0
1202,2011,HU11 5,HU11 5,Total,3759,1836,1923,3759,0,52,5376.98,0.7,-0.271636,53.8667,3944.0
1203,2011,HU12 0,HU12 0,Total,5444,2724,2720,5305,139,41,14255.14,0.4,-0.0135188,53.6926,5417.0
1204,2011,HU12 8,HU12 8,Total,11081,5339,5742,10918,163,124,4152.31,2.7,-0.210593,53.7424,11222.0
1205,2011,HU12 9,HU12 9,Total,9071,4539,4532,9035,36,101,7808.41,1.2,-0.151242,53.7292,8851.0
1206,2011,HU13 0,HU13 0,Total,7464,3570,3894,7156,308,132,414.96,18.0,-0.443103,53.7239,7404.0
1207,2011,HU13 9,HU13 9,Total,7536,3652,3884,7507,29,72,157.08,48.0,-0.42898,53.7266,7669.0
1208,2011,HU14 3,HU14 3,Total,8278,4073,4205,8206,72,190,2452.28,3.4,-0.493353,53.7282,8251.0
1209,2011,HU15 1,HU15 1,Total,13163,6793,6370,12397,766,194,3343.16,3.9,-0.573685,53.7348,12878.0
1210,2011,HU15 2,HU15 2,Total,10984,5361,5623,10898,86,181,6206.85,1.8,-0.664675,53.7603,11337.0
1211,2011,HU16 4,HU16 4,Total,6799,3192,3607,6591,208,111,568.95,12.0,-0.407767,53.7821,6506.0
1212,2011,HU16 5,HU16 5,Total,9667,4705,4962,8401,1266,170,2434.23,4.0,-0.432153,53.7809,9893.0
1213,2011,HU17 0,HU17 0,Total,10226,4982,5244,10169,57,92,1740.04,5.9,-0.412358,53.8392,10164.0
1214,2011,HU17 5,HU17 5,Total,2673,1316,1357,2665,8,34,2257.6,1.2,-0.317161,53.8889,2664.0
1215,2011,HU17 7,HU17 7,Total,8731,4275,4456,8549,182,243,6863.06,1.3,-0.456245,53.8598,9019.0
1216,2011,HU17 8,HU17 8,Total,11492,5464,6028,11099,393,268,3742.55,3.1,-0.445858,53.8343,11296.0
1217,2011,HU17 9,HU17 9,Total,10377,5024,5353,10238,139,136,2617.89,4.0,-0.416951,53.8492,10372.0
1218,2011,HU18 1,HU18 1,Total,8774,4234,4540,8564,210,108,2483.57,3.5,-0.170218,53.9087,8603.0
1219,2011,HU19 2,HU19 2,Total,7135,3558,3577,6953,182,44,3428.71,2.1,0.0341275,53.7233,7120.0
1220,2011,HU20 3,HU20 3,Total,1015,478,537,986,29,27,2599.86,0.4,-0.501818,53.7874,946.0
1221,2011,IG10 1,IG10 1,Total,6794,3319,3475,6735,59,142,464.76,14.6,0.0610629,51.6508,6884.0
1222,2011,IG10 2,IG10 2,Total,9211,4458,4753,9211,0,90,372.66,24.7,0.0759628,51.6555,9009.0
1223,2011,IG10 3,IG10 3,Total,10748,5108,5640,10725,23,99,412.58,26.1,0.0692928,51.6437,10918.0
1224,2011,IG10 4,IG10 4,Total,4774,2328,2446,4749,25,107,887.18,5.4,0.0484576,51.6447,4704.0
1225,2011,IG11 0,IG11 0,Total,9655,4727,4928,9655,0,77,629.17,15.3,0.106097,51.5271,9652.0
1226,2011,IG11 7,IG11 7,Total,15960,8101,7859,15862,98,139,133.78,119.3,0.083755,51.5335,16282.0
1227,2011,IG11 8,IG11 8,Total,8157,4358,3799,8145,12,60,93.11,87.6,0.0803808,51.54,8801.0
1228,2011,IG11 9,IG11 9,Total,19587,9696,9891,19555,32,207,264.97,73.9,0.0979324,51.5406,19116.0
1229,2011,IP10 0,IP10 0,Total,3058,1530,1528,3005,53,68,4553.44,0.7,1.283,52.0074,3209.0
1230,2011,IP11 0,IP11 0,Total,5306,2638,2668,5296,10,66,1578.75,3.4,1.31096,51.9864,5385.0
1231,2011,IP11 2,IP11 2,Total,8816,4328,4488,8700,116,67,564.49,15.6,1.32842,51.9633,8973.0
1232,2011,IP11 7,IP11 7,Total,6505,3036,3469,6181,324,125,179.63,36.2,1.34618,51.9665,6019.0
1233,2011,IP11 9,IP11 9,Total,8669,4133,4536,8648,21,115,934.07,9.3,1.34904,51.9746,8897.0
1234,2011,IP12 1,IP12 1,Total,6707,3166,3541,6646,61,123,648.44,10.3,1.32186,52.1003,6806.0
1235,2011,IP12 2,IP12 2,Total,5519,2669,2850,5470,49,89,9506.59,0.6,1.4487,52.1227,5488.0
1236,2011,IP12 3,IP12 3,Total,4811,2814,1997,3973,838,73,10717.99,0.4,1.40961,52.0634,4827.0
1237,2011,IP12 4,IP12 4,Total,7360,3489,3871,7225,135,166,2161.47,3.4,1.30248,52.0822,7223.0
1238,2011,IP13 0,IP13 0,Total,3992,1905,2087,3921,71,59,4944.86,0.8,1.36554,52.1566,4039.0
1239,2011,IP13 6,IP13 6,Total,4679,2322,2357,4674,5,134,5169.19,0.9,1.27839,52.1124,4549.0
1240,2011,IP13 7,IP13 7,Total,3095,1543,1552,3069,26,95,6684.26,0.5,1.2771,52.2158,3168.0
1241,2011,IP13 8,IP13 8,Total,2264,1124,1140,2258,6,54,5651.6,0.4,1.35678,52.2683,2131.0
1242,2011,IP13 9,IP13 9,Total,4102,1969,2133,3804,298,94,3757.74,1.1,1.34255,52.2192,4147.0
1243,2011,IP14 1,IP14 1,Total,9204,4467,4737,9065,139,104,330.57,27.8,0.989287,52.1903,9414.0
1244,2011,IP14 2,IP14 2,Total,6620,3244,3376,6587,33,100,2578.21,2.6,0.988919,52.1684,6776.0
1245,2011,IP14 3,IP14 3,Total,4545,2201,2344,4381,164,84,4453.54,1.0,0.954674,52.2047,4481.0
1246,2011,IP14 4,IP14 4,Total,5797,2910,2887,5767,30,103,5245.19,1.1,1.015,52.2391,5834.0
1247,2011,IP14 5,IP14 5,Total,8661,4301,4360,8656,5,114,5948.6,1.5,1.05722,52.2114,8429.0
1248,2011,IP14 6,IP14 6,Total,4176,2016,2160,4173,3,106,6911.54,0.6,1.17405,52.2091,4178.0
1249,2011,IP15 5,IP15 5,Total,2466,1115,1351,2424,42,32,968.83,2.5,1.59454,52.1591,2444.0
1250,2011,IP16 4,IP16 4,Total,6546,3166,3380,6417,129,75,3647.33,1.8,1.58357,52.2043,6560.0
1251,2011,IP17 1,IP17 1,Total,6407,3051,3356,6330,77,94,5125.54,1.3,1.49886,52.2004,6467.0
1252,2011,IP17 2,IP17 2,Total,2476,1237,1239,2476,0,48,5855.02,0.4,1.45839,52.2434,2521.0
1253,2011,IP17 3,IP17 3,Total,1901,911,990,1843,58,35,5472.99,0.3,1.55084,52.2688,1957.0
1254,2011,IP18 6,IP18 6,Total,4060,1840,2220,3946,114,62,2210.57,1.8,1.66873,52.3305,4055.0
1255,2011,IP19 0,IP19 0,Total,2364,1184,1180,2361,3,51,9381.13,0.3,1.43882,52.3458,2194.0
1256,2011,IP19 8,IP19 8,Total,5900,2805,3095,5826,74,64,1900.71,3.1,1.50983,52.3476,5921.0
1257,2011,IP19 9,IP19 9,Total,2017,1017,1000,1974,43,45,5653.02,0.4,1.54336,52.3214,1853.0
1258,2011,IP20 0,IP20 0,Total,2511,1234,1277,2511,0,27,5411.72,0.5,1.3494,52.4089,2511.0
1259,2011,IP20 9,IP20 9,Total,5281,2557,2724,5251,30,41,2743.9,1.9,1.29753,52.4041,5299.0
1260,2011,IP21 4,IP21 4,Total,6384,3210,3174,6333,51,81,8706.33,0.7,1.19514,52.391,6240.0
1261,2011,IP21 5,IP21 5,Total,4836,2389,2447,4809,27,79,9040.47,0.5,1.26908,52.3365,4814.0
1262,2011,IP22 1,IP22 1,Total,5374,2609,2765,5329,45,94,7297.79,0.7,1.02499,52.3517,5393.0
1263,2011,IP22 2,IP22 2,Total,5438,2717,2721,5419,19,85,11074.03,0.5,0.996918,52.392,5303.0
1264,2011,IP22 4,IP22 4,Total,8278,3990,4288,8209,69,57,574.82,14.4,1.11228,52.376,8241.0
1265,2011,IP22 5,IP22 5,Total,2786,1375,1411,2734,52,43,3162.61,0.9,1.11366,52.3957,2767.0
1266,2011,IP23 7,IP23 7,Total,4332,2097,2235,4311,21,80,6612.63,0.7,1.14925,52.3059,4317.0
1267,2011,IP23 8,IP23 8,Total,2678,1334,1344,2615,63,50,3528.52,0.8,1.08402,52.3182,2907.0
1268,2011,IP24 1,IP24 1,Total,9879,4882,4997,9856,23,81,8283.23,1.2,0.772839,52.4426,9829.0
1269,2011,IP24 2,IP24 2,Total,9897,4951,4946,9752,145,81,8686.27,1.1,0.762609,52.409,10191.0
1270,2011,IP24 3,IP24 3,Total,8049,3978,4071,8024,25,54,4056.75,2.0,0.730523,52.4067,7816.0
1271,2011,IP25 6,IP25 6,Total,11625,6144,5481,10583,1042,84,5960.84,2.0,0.832821,52.5663,11644.0
1272,2011,IP25 7,IP25 7,Total,6588,3171,3417,6534,54,81,9532.17,0.7,0.838526,52.5962,6520.0
1273,2011,IP26 4,IP26 4,Total,5522,2720,2802,5501,21,50,13232.64,0.4,0.534988,52.4918,5470.0
1274,2011,IP26 5,IP26 5,Total,3423,1718,1705,3343,80,41,13735.21,0.2,0.638546,52.5266,3546.0
1275,2011,IP27 0,IP27 0,Total,11221,5601,5620,11157,64,67,7847.92,1.4,0.623376,52.448,11231.0
1276,2011,IP27 9,IP27 9,Total,7792,4140,3652,6730,1062,42,7616.27,1.0,0.530915,52.4058,7787.0
1277,2011,IP28 6,IP28 6,Total,5584,2769,2815,5290,294,98,14130.01,0.4,0.629045,52.2921,5887.0
1278,2011,IP28 7,IP28 7,Total,9101,4535,4566,9031,70,79,1224.63,7.4,0.515593,52.3457,8923.0
1279,2011,IP28 8,IP28 8,Total,9813,4995,4818,9662,151,65,5334.67,1.8,0.481647,52.3421,9989.0
1280,2011,IP29 4,IP29 4,Total,4415,2177,2238,4390,25,112,8737.64,0.5,0.68391,52.1669,4290.0
1281,2011,IP29 5,IP29 5,Total,4602,2253,2349,4557,45,90,7185.07,0.6,0.639785,52.2265,4521.0
1282,2011,IP30 0,IP30 0,Total,4232,2112,2120,4232,0,77,6958.93,0.6,0.802722,52.1874,4474.0
1283,2011,IP30 9,IP30 9,Total,9342,4590,4752,9338,4,178,5837.06,1.6,0.861499,52.2298,9279.0
1284,2011,IP31 1,IP31 1,Total,6293,3441,2852,5506,787,104,7229.26,0.9,0.787551,52.316,6182.0
1285,2011,IP31 2,IP31 2,Total,7985,3946,4039,7860,125,134,5974.94,1.3,0.819263,52.2901,7920.0
1286,2011,IP31 3,IP31 3,Total,7021,3443,3578,7002,19,174,5762.69,1.2,0.863382,52.2672,7008.0
1287,2011,IP32 6,IP32 6,Total,8793,4326,4467,8756,37,67,243.45,36.1,0.702083,52.2594,8654.0
1288,2011,IP32 7,IP32 7,Total,8298,4155,4143,8289,9,122,453.78,18.3,0.739967,52.2466,8251.0
1289,2011,IP33 1,IP33 1,Total,4438,2167,2271,4271,167,76,148.15,30.0,0.715607,52.2461,4562.0
1290,2011,IP33 2,IP33 2,Total,9430,4598,4832,9334,96,154,535.19,17.6,0.713384,52.2361,9254.0
1291,2011,IP33 3,IP33 3,Total,10337,5048,5289,10214,123,159,712.25,14.5,0.697908,52.2454,10581.0
1292,2011,KT10 0,KT10 0,Total,9577,4629,4948,9480,97,272,653.49,14.7,-0.341571,51.3652,9697.0
1293,2011,KT10 8,KT10 8,Total,6312,3059,3253,6299,13,167,493.81,12.8,-0.365767,51.3755,6206.0
1294,2011,KT10 9,KT10 9,Total,5004,2480,2524,4966,38,221,642.89,7.8,-0.362118,51.3692,5146.0
1295,2011,KT11 1,KT11 1,Total,3111,1467,1644,3014,97,54,370.8,8.4,-0.420591,51.3294,4010.0
1296,2011,KT11 2,KT11 2,Total,9194,4492,4702,8957,237,368,1008.11,9.1,-0.395403,51.3319,8546.0
1297,2011,KT11 3,KT11 3,Total,2675,1309,1366,2624,51,85,1228.96,2.2,-0.400352,51.3204,2772.0
1298,2011,KT12 1,KT12 1,Total,4305,2102,2203,4284,21,97,158.78,27.1,-0.416509,51.3797,4820.0
1299,2011,KT12 2,KT12 2,Total,11771,5717,6054,11771,0,154,467.57,25.2,-0.411514,51.3874,11248.0
1300,2011,KT12 3,KT12 3,Total,8061,3883,4178,7956,105,144,338.58,23.8,-0.398542,51.3805,7829.0
1301,2011,KT12 4,KT12 4,Total,5614,2670,2944,5502,112,48,709.0,7.9,-0.404568,51.3654,5723.0
1302,2011,KT12 5,KT12 5,Total,7083,3418,3665,7049,34,166,340.04,20.8,-0.410071,51.3695,6673.0
1303,2011,KT13 0,KT13 0,Total,6581,3185,3396,6459,122,195,676.83,9.7,-0.451094,51.3605,6900.0
1304,2011,KT13 8,KT13 8,Total,7147,3502,3645,7099,48,106,440.21,16.2,-0.457722,51.373,7097.0
1305,2011,KT13 9,KT13 9,Total,7564,3706,3858,7485,79,153,221.44,34.2,-0.443615,51.3726,7715.0
1306,2011,KT14 6,KT14 6,Total,5626,2707,2919,5586,40,174,351.11,16.0,-0.499289,51.339,5685.0
1307,2011,KT14 7,KT14 7,Total,7724,3737,3987,7662,62,68,285.31,27.1,-0.475798,51.3401,7551.0
1308,2011,KT15 1,KT15 1,Total,9820,4727,5093,9633,187,136,433.37,22.7,-0.501099,51.3665,9265.0
1309,2011,KT15 2,KT15 2,Total,8257,4048,4209,8253,4,74,400.46,20.6,-0.486698,51.3725,8696.0
1310,2011,KT15 3,KT15 3,Total,9296,4593,4703,9232,64,150,531.6,17.5,-0.499403,51.3516,9079.0
1311,2011,KT16 0,KT16 0,Total,5672,2754,2918,5558,114,91,1834.57,3.1,-0.536451,51.3716,5596.0
1312,2011,KT16 8,KT16 8,Total,5991,2948,3043,5930,61,46,448.93,13.3,-0.498561,51.3909,6360.0
1313,2011,KT16 9,KT16 9,Total,6799,3396,3403,6735,64,82,436.18,15.6,-0.511286,51.3874,6538.0
1314,2011,KT17 1,KT17 1,Total,5362,2578,2784,5261,101,81,174.38,30.7,-0.254951,51.3428,5246.0
1315,2011,KT17 2,KT17 2,Total,7825,3827,3998,7825,0,157,340.32,23.0,-0.246434,51.3538,8012.0
1316,2011,KT17 3,KT17 3,Total,3970,1920,2050,3926,44,115,370.43,10.7,-0.242276,51.332,4405.0
1317,2011,KT17 4,KT17 4,Total,6145,3026,3119,5711,434,113,205.24,29.9,-0.256832,51.3316,5746.0
1318,2011,KT18 5,KT18 5,Total,7921,3775,4146,7763,158,142,313.78,25.2,-0.250779,51.321,7840.0
1319,2011,KT18 6,KT18 6,Total,2113,1056,1057,2102,11,51,974.61,2.2,-0.271439,51.2965,2069.0
1320,2011,KT18 7,KT18 7,Total,7411,3435,3976,7270,141,128,630.19,11.8,-0.274643,51.3278,7091.0
1321,2011,KT19 0,KT19 0,Total,9009,4458,4551,9009,0,141,227.21,39.7,-0.259413,51.3619,9100.0
1322,2011,KT19 7,KT19 7,Total,1849,914,935,1804,45,22,252.6,7.3,-0.284226,51.3439,1797.0
1323,2011,KT19 8,KT19 8,Total,7952,3859,4093,7818,134,134,263.74,30.2,-0.274147,51.3391,8464.0
1324,2011,KT19 9,KT19 9,Total,15288,7436,7852,15255,33,182,320.22,47.7,-0.269512,51.3531,15159.0
1325,2011,KT20 5,KT20 5,Total,10331,4993,5338,10180,151,195,467.74,22.1,-0.233582,51.2964,10302.0
1326,2011,KT20 6,KT20 6,Total,5725,2781,2944,5585,140,132,963.36,5.9,-0.215361,51.2893,5346.0
1327,2011,KT20 7,KT20 7,Total,4503,2235,2268,4437,66,72,1893.85,2.4,-0.246894,51.2711,4633.0
1328,2011,KT21 1,KT21 1,Total,5858,2820,3038,5804,54,147,514.36,11.4,-0.296216,51.3133,6038.0
1329,2011,KT21 2,KT21 2,Total,7868,3772,4096,7677,191,215,631.52,12.5,-0.307881,51.3095,7427.0
1330,2011,KT22 0,KT22 0,Total,3921,1893,2028,3782,139,181,1089.19,3.6,-0.351223,51.3242,3679.0
1331,2011,KT22 7,KT22 7,Total,6518,3315,3203,6517,1,51,265.14,24.6,-0.331753,51.3021,6855.0
1332,2011,KT22 8,KT22 8,Total,4724,2311,2413,4539,185,144,649.64,7.3,-0.322566,51.2928,4681.0
1333,2011,KT22 9,KT22 9,Total,8991,4459,4532,8904,87,263,1011.77,8.9,-0.351318,51.2919,8704.0
1334,2011,KT23 3,KT23 3,Total,5090,2411,2679,5052,38,122,406.28,12.5,-0.374788,51.2859,5033.0
1335,2011,KT23 4,KT23 4,Total,5604,2665,2939,5580,24,127,666.88,8.4,-0.367568,51.2784,6021.0
1336,2011,KT24 5,KT24 5,Total,5233,2516,2717,5173,60,234,1822.77,2.9,-0.417334,51.2707,4806.0
1337,2011,KT24 6,KT24 6,Total,4282,2035,2247,4197,85,159,1192.55,3.6,-0.442837,51.2683,4234.0
1338,2011,LA10 5,LA10 5,Total,4002,2066,1936,3550,452,90,27434.11,0.1,-2.49759,54.3148,3767.0
1339,2011,LA11 6,LA11 6,Total,3717,1784,1933,3631,86,59,6225.21,0.6,-2.90837,54.2149,3915.0
1340,2011,LA11 7,LA11 7,Total,5956,2848,3108,5803,153,92,4428.7,1.3,-2.94073,54.1844,5912.0
1341,2011,LA12 0,LA12 0,Total,6055,2963,3092,6023,32,119,4052.32,1.5,-3.12037,54.1717,6110.0
1342,2011,LA12 7,LA12 7,Total,4456,2208,2248,4445,11,83,3008.82,1.5,-3.09172,54.2044,4702.0
1343,2011,LA12 8,LA12 8,Total,2414,1229,1185,2368,46,54,15464.61,0.2,-3.01986,54.2672,2241.0
1344,2011,LA12 9,LA12 9,Total,7269,3525,3744,7067,202,90,1434.63,5.1,-3.08784,54.1818,6995.0
1345,2011,LA13 0,LA13 0,Total,8774,4335,4439,8772,2,134,2156.51,4.1,-3.1887,54.1175,8520.0
1346,2011,LA13 9,LA13 9,Total,10038,4957,5081,9931,107,127,340.7,29.5,-3.20893,54.119,10564.0
1347,2011,LA14 1,LA14 1,Total,3342,1711,1631,3309,33,21,146.41,22.8,-3.22683,54.1148,3566.0
1348,2011,LA14 2,LA14 2,Total,7199,3660,3539,7057,142,40,377.55,19.1,-3.22573,54.1092,6859.0
1349,2011,LA14 3,LA14 3,Total,10651,5185,5466,10592,59,84,1327.3,8.0,-3.25368,54.1089,10651.0
1350,2011,LA14 4,LA14 4,Total,6545,3192,3353,6452,93,75,786.51,8.3,-3.2213,54.138,6583.0
1351,2011,LA14 5,LA14 5,Total,10776,5318,5458,10594,182,117,216.47,49.8,-3.22591,54.1225,10577.0
1352,2011,LA15 8,LA15 8,Total,7827,3863,3964,7782,45,91,609.8,12.8,-3.1797,54.1558,7913.0
1353,2011,LA16 7,LA16 7,Total,3462,1723,1739,3430,32,45,1923.14,1.8,-3.2028,54.1841,3345.0
1354,2011,LA17 7,LA17 7,Total,1174,577,597,1174,0,10,3901.39,0.3,-3.1756,54.2399,1146.0
1355,2011,LA18 4,LA18 4,Total,5730,3091,2639,5142,588,45,4836.23,1.2,-3.27627,54.2069,5604.0
1356,2011,LA18 5,LA18 5,Total,3340,1630,1710,3303,37,40,4661.25,0.7,-3.27465,54.2269,3343.0
1357,2011,LA19 5,LA19 5,Total,972,475,497,958,14,10,5275.31,0.2,-3.37172,54.2893,1048.0
1358,2011,LA20 6,LA20 6,Total,1159,581,578,1159,0,37,12235.89,0.1,-3.2068,54.2929,1229.0
1359,2011,LA21 8,LA21 8,Total,928,464,464,899,29,20,4093.32,0.2,-3.07162,54.3646,1062.0
1360,2011,LA22 0,LA22 0,Total,2170,1070,1100,2031,139,27,4961.07,0.4,-2.96973,54.4007,2043.0
1361,2011,LA22 9,LA22 9,Total,2773,1380,1393,2531,242,57,8899.81,0.3,-2.99862,54.4395,2979.0
1362,2011,LA23 1,LA23 1,Total,2785,1295,1490,2421,364,49,5944.98,0.5,-2.91192,54.389,2573.0
1363,2011,LA23 2,LA23 2,Total,4048,1984,2064,3957,91,84,366.74,11.0,-2.90579,54.3723,4216.0
1364,2011,LA23 3,LA23 3,Total,2304,1161,1143,2116,188,34,2574.62,0.9,-2.91971,54.3536,2312.0
1365,2011,LE10 0,LE10 0,Total,20354,10120,10234,20306,48,142,993.39,20.5,-1.3855,52.5431,20306.0
1366,2011,LE10 1,LE10 1,Total,10327,5141,5186,10179,148,147,535.67,19.3,-1.36694,52.5452,10126.0
1367,2011,LE10 2,LE10 2,Total,14568,7046,7522,14521,47,178,1256.87,11.6,-1.3611,52.5304,14362.0
1368,2011,LE10 3,LE10 3,Total,2225,1112,1113,2225,0,36,3380.99,0.7,-1.36119,52.5225,2717.0
1369,2011,LE11 1,LE11 1,Total,9835,5099,4736,9689,146,96,526.33,18.7,-1.20295,52.7735,9934.0
1370,2011,LE11 2,LE11 2,Total,13840,6777,7063,13776,64,188,521.93,26.5,-1.20638,52.7588,13859.0
1371,2011,LE11 3,LE11 3,Total,16441,9018,7423,10814,5627,403,1033.75,15.9,-1.22224,52.7648,16357.0
1372,2011,LE11 4,LE11 4,Total,9722,4949,4773,9617,105,153,466.61,20.8,-1.23838,52.7721,9938.0
1373,2011,LE11 5,LE11 5,Total,10529,5442,5087,10331,198,128,463.04,22.7,-1.22238,52.7791,10230.0
1374,2011,LE12 5,LE12 5,Total,7482,3567,3915,6895,587,146,6853.11,1.1,-1.21826,52.8001,7468.0
1375,2011,LE12 6,LE12 6,Total,9193,4434,4759,9142,51,158,4538.47,2.0,-1.15889,52.8223,9164.0
1376,2011,LE12 7,LE12 7,Total,16604,8159,8445,16429,175,190,2358.54,7.0,-1.1264,52.7308,16361.0
1377,2011,LE12 8,LE12 8,Total,13957,6844,7113,13577,380,274,4304.17,3.2,-1.16986,52.7451,14152.0
1378,2011,LE12 9,LE12 9,Total,14886,7319,7567,14565,321,199,4645.19,3.2,-1.28878,52.7692,14764.0
1379,2011,LE13 0,LE13 0,Total,15198,7429,7769,14967,231,135,1423.26,10.7,-0.891256,52.7635,14705.0
1380,2011,LE13 1,LE13 1,Total,11960,5884,6076,11899,61,134,882.93,13.5,-0.880037,52.7694,12387.0
1381,2011,LE14 2,LE14 2,Total,4514,2285,2229,4495,19,103,12997.54,0.3,-0.866767,52.731,4601.0
1382,2011,LE14 3,LE14 3,Total,6621,3206,3415,6583,38,100,8764.13,0.8,-0.964927,52.789,6656.0
1383,2011,LE14 4,LE14 4,Total,6186,3032,3154,6112,74,137,13468.4,0.5,-0.857185,52.828,6011.0
1384,2011,LE15 6,LE15 6,Total,10922,5260,5662,10432,490,201,909.0,12.0,-0.728759,52.6726,10907.0
1385,2011,LE15 7,LE15 7,Total,8135,4488,3647,7073,1062,183,12495.27,0.7,-0.700519,52.7055,8068.0
1386,2011,LE15 8,LE15 8,Total,6416,3274,3142,5954,462,172,14244.65,0.5,-0.667299,52.6435,6452.0
1387,2011,LE15 9,LE15 9,Total,6852,3401,3451,5856,996,180,6402.04,1.1,-0.716398,52.5988,7094.0
1388,2011,LE16 7,LE16 7,Total,11868,6154,5714,11076,792,220,7408.14,1.6,-0.91834,52.4925,11819.0
1389,2011,LE16 8,LE16 8,Total,10331,5034,5297,10224,107,240,16368.73,0.6,-0.839252,52.4945,9865.0
1390,2011,LE16 9,LE16 9,Total,12776,6236,6540,12597,179,228,4928.48,2.6,-0.934788,52.4699,12774.0
1391,2011,LE17 4,LE17 4,Total,10597,5286,5311,10521,76,170,4185.4,2.5,-1.2058,52.4597,10560.0
1392,2011,LE17 5,LE17 5,Total,6117,3076,3041,6117,0,138,7374.26,0.8,-1.20427,52.4925,6108.0
1393,2011,LE17 6,LE17 6,Total,3934,1962,1972,3857,77,85,7173.81,0.5,-1.10426,52.4488,4105.0
1394,2011,LE18 1,LE18 1,Total,7885,3770,4115,7770,115,72,152.9,51.6,-1.10998,52.5902,8563.0
1395,2011,LE18 2,LE18 2,Total,8628,4092,4536,8494,134,81,342.5,25.2,-1.11223,52.581,8155.0
1396,2011,LE18 3,LE18 3,Total,8171,4058,4113,8165,6,115,1518.21,5.4,-1.09621,52.5804,8144.0
1397,2011,LE18 4,LE18 4,Total,8177,4220,3957,7539,638,43,334.88,24.4,-1.12919,52.5818,8011.0
1398,2011,LE19 2,LE19 2,Total,5916,2879,3037,5865,51,48,555.53,10.6,-1.20644,52.5747,5993.0
1399,2011,LE19 3,LE19 3,Total,4741,2350,2391,4735,6,89,331.76,14.3,-1.2221,52.5768,4637.0
1400,2011,LE19 4,LE19 4,Total,4105,2019,2086,4075,30,35,914.13,4.5,-1.21858,52.5938,4143.0
1401,2011,LE65 1,LE65 1,Total,6198,3095,3103,6147,51,123,2502.56,2.5,-1.46097,52.7481,6129.0
1402,2011,LE65 2,LE65 2,Total,7827,3767,4060,7685,142,119,1597.59,4.9,-1.47931,52.7496,8033.0
1403,2011,LE67 1,LE67 1,Total,5471,2712,2759,5460,11,50,2380.64,2.3,-1.34827,52.6907,5446.0
1404,2011,LE67 2,LE67 2,Total,7644,3791,3853,7616,28,104,3069.71,2.5,-1.39377,52.711,7585.0
1405,2011,LE67 3,LE67 3,Total,8671,4300,4371,8548,123,45,578.89,15.0,-1.37506,52.7238,8534.0
1406,2011,LE67 4,LE67 4,Total,10742,5281,5461,10688,54,91,908.51,11.8,-1.34298,52.7219,10797.0
1407,2011,LE67 5,LE67 5,Total,8486,4153,4333,8460,26,96,641.18,13.2,-1.35705,52.7396,8759.0
1408,2011,LE67 6,LE67 6,Total,5961,2966,2995,5909,52,69,861.27,6.9,-1.39768,52.6938,5961.0
1409,2011,LE67 8,LE67 8,Total,5954,2968,2986,5904,50,78,2210.77,2.7,-1.38739,52.7516,5712.0
1410,2011,LE67 9,LE67 9,Total,5975,2903,3072,5906,69,90,1762.47,3.4,-1.28246,52.6882,6030.0
1411,2011,LN10 5,LN10 5,Total,861,416,445,821,40,16,5112.83,0.2,-0.23671,53.194,720.0
1412,2011,LN10 6,LN10 6,Total,5124,2473,2651,4988,136,95,3733.41,1.4,-0.212353,53.1516,5257.0
1413,2011,LN11 0,LN11 0,Total,9896,4781,5115,9706,190,137,12787.43,0.8,-0.00946786,53.3855,9503.0
1414,2011,LN11 7,LN11 7,Total,5152,2565,2587,5145,7,49,12092.99,0.4,0.10231,53.4137,5221.0
1415,2011,LN11 8,LN11 8,Total,8144,3945,4199,8081,63,125,11431.19,0.7,0.0445628,53.3487,8071.0
1416,2011,LN11 9,LN11 9,Total,5030,2407,2623,5011,19,82,6197.15,0.8,-0.029693,53.3509,5402.0
1417,2011,LN12 1,LN12 1,Total,5062,2435,2627,4906,156,40,2571.87,2.0,0.249357,53.346,5019.0
1418,2011,LN12 2,LN12 2,Total,8159,3880,4279,8000,159,43,1805.13,4.5,0.27339,53.3185,8225.0
1419,2011,LN13 0,LN13 0,Total,2635,1295,1340,2604,31,41,9983.77,0.3,0.146286,53.2843,2730.0
1420,2011,LN13 9,LN13 9,Total,5131,2470,2661,5039,92,43,7465.6,0.7,0.205399,53.2536,5071.0
1421,2011,LS10 1,LS10 1,Total,4096,2186,1910,3485,611,18,94.09,43.5,-1.52797,53.7829,4116.0
1422,2011,LS10 2,LS10 2,Total,3792,1830,1962,3753,39,10,431.95,8.8,-1.52844,53.7752,3969.0
1423,2011,LS10 3,LS10 3,Total,12752,6144,6608,12676,76,50,442.46,28.8,-1.53086,53.759,12731.0
1424,2011,LS10 4,LS10 4,Total,14894,7105,7789,14856,38,71,664.17,22.4,-1.53883,53.7476,14800.0
1425,2011,LS11 0,LS11 0,Total,3834,1924,1910,3834,0,20,122.0,31.4,-1.57192,53.7746,3986.0
1426,2011,LS11 5,LS11 5,Total,5164,2579,2585,5147,17,32,232.67,22.2,-1.54875,53.7769,5180.0
1427,2011,LS11 6,LS11 6,Total,6572,3444,3128,6532,40,21,107.55,61.1,-1.54955,53.7777,6305.0
1428,2011,LS11 7,LS11 7,Total,8856,4547,4309,8830,26,45,105.79,83.7,-1.55787,53.7725,9019.0
1429,2011,LS11 8,LS11 8,Total,7659,3798,3861,7581,78,43,261.55,29.3,-1.56457,53.7743,7658.0
1430,2011,LS11 9,LS11 9,Total,2710,1484,1226,2704,6,7,97.42,27.8,-1.55649,53.7871,2589.0
1431,2011,LS12 1,LS12 1,Total,5834,3072,2762,5742,92,17,220.49,26.5,-1.57843,53.7932,5251.0
1432,2011,LS12 2,LS12 2,Total,6042,3279,2763,5546,496,19,193.61,31.2,-1.58955,53.8003,6753.0
1433,2011,LS12 3,LS12 3,Total,8791,4471,4320,8691,100,49,191.65,45.9,-1.60074,53.7969,8332.0
1434,2011,LS12 4,LS12 4,Total,9327,4533,4794,9120,207,50,292.36,31.9,-1.59438,53.7883,9188.0
1435,2011,LS12 5,LS12 5,Total,9423,4487,4936,9395,28,61,627.03,15.0,-1.61724,53.7845,9415.0
1436,2011,LS12 6,LS12 6,Total,1532,774,758,1532,0,9,55.36,27.7,-1.58838,53.7807,1797.0
1437,2011,LS13 1,LS13 1,Total,7356,3664,3692,7348,8,50,364.03,20.2,-1.65199,53.8193,6979.0
1438,2011,LS13 2,LS13 2,Total,10551,5022,5529,10496,55,38,267.8,39.4,-1.62452,53.8134,10759.0
1439,2011,LS13 3,LS13 3,Total,7225,3447,3778,7220,5,40,143.54,50.3,-1.63568,53.8101,7273.0
1440,2011,LS13 4,LS13 4,Total,9889,4855,5034,9884,5,59,228.77,43.2,-1.63287,53.8024,9746.0
1441,2011,LS14 1,LS14 1,Total,7912,3743,4169,7878,34,77,227.54,34.8,-1.46934,53.829,7865.0
1442,2011,LS14 2,LS14 2,Total,4501,2178,2323,4482,19,20,230.62,19.5,-1.45488,53.8316,4634.0
1443,2011,LS14 3,LS14 3,Total,3179,1535,1644,3179,0,75,1863.41,1.7,-1.44026,53.8564,3131.0
1444,2011,LS14 5,LS14 5,Total,7372,3469,3903,7339,33,29,211.04,34.9,-1.44612,53.821,7223.0
1445,2011,LS14 6,LS14 6,Total,11520,5509,6011,11453,67,53,359.99,32.0,-1.46834,53.8145,11189.0
1446,2011,LS15 0,LS15 0,Total,7696,3667,4029,7696,0,63,1010.42,7.6,-1.47142,53.7953,7809.0
1447,2011,LS15 4,LS15 4,Total,5195,2500,2695,5187,8,82,2818.1,1.8,-1.41097,53.8275,4964.0
1448,2011,LS15 7,LS15 7,Total,9467,4581,4886,9455,12,97,224.79,42.1,-1.45936,53.8039,9268.0
1449,2011,LS15 8,LS15 8,Total,8739,4190,4549,8703,36,82,814.25,10.7,-1.44166,53.8086,8920.0
1450,2011,LS15 9,LS15 9,Total,3894,1911,1983,3875,19,57,276.41,14.1,-1.44345,53.7957,3729.0
1451,2011,LS16 5,LS16 5,Total,8019,3964,4055,7004,1015,141,308.8,26.0,-1.59488,53.8348,8354.0
1452,2011,LS16 6,LS16 6,Total,9546,4554,4992,9489,57,113,336.15,28.4,-1.60777,53.8454,9598.0
1453,2011,LS16 7,LS16 7,Total,10966,5311,5655,10964,2,176,661.62,16.6,-1.61444,53.8553,10724.0
1454,2011,LS16 8,LS16 8,Total,4114,1962,2152,3732,382,112,1137.92,3.6,-1.58444,53.8518,3997.0
1455,2011,LS16 9,LS16 9,Total,3812,1833,1979,3784,28,94,858.87,4.4,-1.61517,53.8777,3715.0
1456,2011,LS17 0,LS17 0,Total,1389,688,701,1389,0,49,1796.36,0.8,-1.57512,53.9257,1357.0
1457,2011,LS17 5,LS17 5,Total,7154,3478,3676,7144,10,88,223.76,32.0,-1.553,53.8447,7274.0
1458,2011,LS17 6,LS17 6,Total,10016,4872,5144,9967,49,180,212.6,47.1,-1.53513,53.8436,9853.0
1459,2011,LS17 7,LS17 7,Total,9409,4498,4911,9389,20,221,432.46,21.8,-1.54609,53.8559,9302.0
1460,2011,LS17 8,LS17 8,Total,10909,5203,5706,10879,30,231,667.7,16.3,-1.51107,53.8534,10914.0
1461,2011,LS17 9,LS17 9,Total,4549,2217,2332,4549,0,127,3753.08,1.2,-1.47751,53.8816,4493.0
1462,2011,LS18 4,LS18 4,Total,9326,4451,4875,9272,54,114,287.29,32.5,-1.6448,53.8363,9290.0
1463,2011,LS18 5,LS18 5,Total,9569,4658,4911,9341,228,133,519.29,18.4,-1.64438,53.8461,9869.0
1464,2011,LS19 6,LS19 6,Total,6238,3027,3211,6208,30,112,509.2,12.3,-1.68049,53.8528,6712.0
1465,2011,LS19 7,LS19 7,Total,13597,6573,7024,13492,105,143,1286.66,10.6,-1.68707,53.8652,13186.0
1466,2011,LS20 8,LS20 8,Total,6947,3427,3520,6947,0,140,1067.01,6.5,-1.72002,53.8714,6925.0
1467,2011,LS20 9,LS20 9,Total,5716,2724,2992,5618,98,60,512.12,11.2,-1.70618,53.8757,5394.0
1468,2011,LS21 1,LS21 1,Total,5753,2833,2920,5703,50,104,1150.41,5.0,-1.66216,53.9033,6004.0
1469,2011,LS21 2,LS21 2,Total,7081,3418,3663,7080,1,110,8586.95,0.8,-1.6938,53.9262,7196.0
1470,2011,LS21 3,LS21 3,Total,4895,2368,2527,4855,40,74,921.71,5.3,-1.69658,53.9018,4646.0
1471,2011,LS22 4,LS22 4,Total,1957,951,1006,1931,26,45,3501.03,0.6,-1.39998,53.9332,1787.0
1472,2011,LS22 5,LS22 5,Total,3765,1949,1816,3565,200,95,3074.07,1.2,-1.3912,53.9268,3957.0
1473,2011,LS22 6,LS22 6,Total,5862,2784,3078,5835,27,118,799.88,7.3,-1.39061,53.9306,6040.0
1474,2011,LS22 7,LS22 7,Total,4207,2023,2184,4156,51,76,127.03,33.1,-1.38666,53.9373,3963.0
1475,2011,LS23 6,LS23 6,Total,7391,3507,3884,7358,33,153,2629.12,2.8,-1.35506,53.8988,7343.0
1476,2011,LS23 7,LS23 7,Total,1816,1299,517,1003,813,24,1272.21,1.4,-1.34906,53.9212,1806.0
1477,2011,LS24 8,LS24 8,Total,3286,1634,1652,3286,0,50,3766.27,0.9,-1.2478,53.8964,3347.0
1478,2011,LS24 9,LS24 9,Total,8563,4174,4389,8523,40,158,8198.57,1.0,-1.25719,53.8606,8473.0
1479,2011,LS25 1,LS25 1,Total,7571,3558,4013,7459,112,76,242.26,31.3,-1.39061,53.791,7589.0
1480,2011,LS25 2,LS25 2,Total,7396,3591,3805,7385,11,93,684.45,10.8,-1.37677,53.7925,7464.0
1481,2011,LS25 3,LS25 3,Total,1503,735,768,1503,0,23,1797.14,0.8,-1.34595,53.8264,1513.0
1482,2011,LS25 4,LS25 4,Total,1893,955,938,1893,0,8,718.79,2.6,-1.33548,53.7903,1935.0
1483,2011,LS25 5,LS25 5,Total,4693,2297,2396,4681,12,72,4360.93,1.1,-1.24707,53.7675,4674.0
1484,2011,LS25 6,LS25 6,Total,6778,3354,3424,6750,28,90,2254.07,3.0,-1.2422,53.7944,6888.0
1485,2011,LS25 7,LS25 7,Total,10083,4915,5168,10048,35,99,699.39,14.4,-1.37353,53.7704,10164.0
1486,2011,LS26 0,LS26 0,Total,13961,6654,7307,13845,116,112,808.27,17.3,-1.47907,53.7532,13880.0
1487,2011,LS26 8,LS26 8,Total,11914,5821,6093,11892,22,95,927.64,12.8,-1.43575,53.7577,12148.0
1488,2011,LS26 9,LS26 9,Total,4146,2025,2121,4073,73,34,867.15,4.8,-1.40541,53.7404,4292.0
1489,2011,LS27 0,LS27 0,Total,6553,3197,3356,6530,23,32,555.24,11.8,-1.61408,53.7441,7063.0
1490,2011,LS27 7,LS27 7,Total,10556,5128,5428,10515,41,71,842.04,12.5,-1.61263,53.7582,10475.0
1491,2011,LS27 8,LS27 8,Total,9906,4790,5116,9832,74,69,459.17,21.6,-1.59159,53.7466,9706.0
1492,2011,LS27 9,LS27 9,Total,8680,4241,4439,8609,71,61,225.49,38.5,-1.60303,53.7482,8438.0
1493,2011,LS28 5,LS28 5,Total,11426,5486,5940,11347,79,109,828.11,13.8,-1.67653,53.8141,12024.0
1494,2011,LS28 6,LS28 6,Total,3229,1560,1669,3226,3,27,156.16,20.7,-1.66363,53.8059,3242.0
1495,2011,LS28 7,LS28 7,Total,9603,4588,5015,9454,149,70,300.89,31.9,-1.67129,53.7982,9338.0
1496,2011,LS28 8,LS28 8,Total,7539,3588,3951,7446,93,91,339.76,22.2,-1.67435,53.7924,7580.0
1497,2011,LS28 9,LS28 9,Total,6099,2900,3199,6071,28,48,277.59,22.0,-1.65434,53.7931,6221.0
1498,2011,LS29 0,LS29 0,Total,5016,2421,2595,5016,0,133,4435.71,1.1,-1.86189,53.941,5124.0
1499,2011,LS29 6,LS29 6,Total,5188,2510,2678,5169,19,124,396.44,13.1,-1.74657,53.893,5554.0
1500,2011,LS29 7,LS29 7,Total,7338,3570,3768,7299,39,194,1298.33,5.7,-1.7589,53.9114,7231.0
1501,2011,LS29 8,LS29 8,Total,8071,3838,4233,7990,81,188,1390.38,5.8,-1.81004,53.9245,7882.0
1502,2011,LS29 9,LS29 9,Total,5843,2711,3132,5570,273,198,251.24,23.3,-1.83061,53.924,5962.0
1503,2011,ME10 1,ME10 1,Total,13536,6572,6964,13369,167,132,375.55,36.0,0.721815,51.3393,13425.0
1504,2011,ME10 2,ME10 2,Total,14571,7140,7431,14479,92,108,672.11,21.7,0.734523,51.353,14671.0
1505,2011,ME10 3,ME10 3,Total,7399,3642,3757,7347,52,53,433.59,17.1,0.751778,51.3426,7415.0
1506,2011,ME10 4,ME10 4,Total,9344,4593,4751,9235,109,97,354.06,26.4,0.740773,51.3351,9478.0
1507,2011,ME10 5,ME10 5,Total,2732,1356,1376,2732,0,21,99.82,27.4,0.717053,51.3508,2671.0
1508,2011,ME11 5,ME11 5,Total,3407,1671,1736,3407,0,22,720.59,4.7,0.748295,51.4137,3398.0
1509,2011,ME12 1,ME12 1,Total,6686,3278,3408,6657,29,28,403.09,16.6,0.757375,51.4369,6779.0
1510,2011,ME12 2,ME12 2,Total,12721,6223,6498,12577,144,102,547.85,23.2,0.787956,51.4314,12104.0
1511,2011,ME12 3,ME12 3,Total,11062,5444,5618,10983,79,74,2800.59,3.9,0.790729,51.4193,11656.0
1512,2011,ME12 4,ME12 4,Total,6415,3828,2587,5119,1296,30,4614.55,1.4,0.879276,51.4067,6354.0
1513,2011,ME13 0,ME13 0,Total,3508,1740,1768,3492,16,61,8129.33,0.4,0.851337,51.2853,3051.0
1514,2011,ME13 7,ME13 7,Total,9316,4537,4779,9294,22,84,551.69,16.9,0.884226,51.3185,9033.0
1515,2011,ME13 8,ME13 8,Total,10000,4759,5241,9857,143,107,564.01,17.7,0.892819,51.3115,10469.0
1516,2011,ME13 9,ME13 9,Total,5135,2489,2646,5005,130,81,5502.83,0.9,0.942763,51.2985,5174.0
1517,2011,ME14 1,ME14 1,Total,3247,1912,1335,2586,661,16,64.9,50.0,0.524158,51.2743,3071.0
1518,2011,ME14 2,ME14 2,Total,10705,5463,5242,10386,319,121,274.71,39.0,0.525024,51.2841,10419.0
1519,2011,ME14 3,ME14 3,Total,1953,995,958,1948,5,34,2397.24,0.8,0.553557,51.2982,2061.0
1520,2011,ME14 4,ME14 4,Total,6277,3026,3251,6135,142,186,1499.67,4.2,0.568569,51.2724,5795.0
1521,2011,ME14 5,ME14 5,Total,9532,4679,4853,9486,46,160,373.58,25.5,0.540572,51.2767,10070.0
1522,2011,ME15 0,ME15 0,Total,4039,2016,2023,3984,55,77,1989.8,2.0,0.490081,51.243,4202.0
1523,2011,ME15 6,ME15 6,Total,10536,5143,5393,10403,133,76,369.35,28.5,0.521191,51.2655,10250.0
1524,2011,ME15 7,ME15 7,Total,10888,5406,5482,10860,28,95,297.8,36.6,0.53829,51.2599,11265.0
1525,2011,ME15 8,ME15 8,Total,11055,5325,5730,10930,125,78,655.11,16.9,0.557978,51.2561,11479.0
1526,2011,ME15 9,ME15 9,Total,11141,5344,5797,11110,31,95,372.31,29.9,0.542732,51.2467,10762.0
1527,2011,ME16 0,ME16 0,Total,13260,6482,6778,13074,186,188,482.77,27.5,0.500987,51.28,13248.0
1528,2011,ME16 8,ME16 8,Total,11475,5630,5845,11105,370,152,261.11,43.9,0.507176,51.2691,11298.0
1529,2011,ME16 9,ME16 9,Total,5311,2566,2745,5254,57,51,494.83,10.7,0.482668,51.2678,5543.0
1530,2011,ME17 1,ME17 1,Total,4742,2356,2386,4690,52,67,4898.38,1.0,0.644351,51.2467,5230.0
1531,2011,ME17 2,ME17 2,Total,3969,1954,2015,3953,16,52,4016.26,1.0,0.691312,51.2362,3809.0
1532,2011,ME17 3,ME17 3,Total,5728,2815,2913,5465,263,100,3370.17,1.7,0.587707,51.2274,5243.0
1533,2011,ME17 4,ME17 4,Total,7950,3937,4013,7906,44,103,2073.5,3.8,0.515087,51.2354,7785.0
1534,2011,ME18 5,ME18 5,Total,4694,2295,2399,4652,42,98,2878.17,1.6,0.41923,51.2573,4602.0
1535,2011,ME18 6,ME18 6,Total,2109,1032,1077,2104,5,38,1063.05,2.0,0.429907,51.2211,2366.0
1536,2011,ME19 4,ME19 4,Total,7770,3889,3881,7770,0,96,331.75,23.4,0.408276,51.28,7783.0
1537,2011,ME19 5,ME19 5,Total,6360,3113,3247,6350,10,107,3026.94,2.1,0.400181,51.308,6296.0
1538,2011,ME19 6,ME19 6,Total,7667,3644,4023,7577,90,103,1116.56,6.9,0.423893,51.294,7603.0
1539,2011,ME20 6,ME20 6,Total,13367,6581,6786,13330,37,133,788.02,17.0,0.44519,51.3058,13266.0
1540,2011,ME20 7,ME20 7,Total,7278,3551,3727,7195,83,74,1461.31,5.0,0.4738,51.3061,7379.0
1541,2011,MK10 7,MK10 7,Total,2513,1258,1255,2507,6,26,206.47,12.2,-0.684317,52.0473,2346.0
1542,2011,MK10 9,MK10 9,Total,11312,5730,5582,11312,0,136,579.6,19.5,-0.703767,52.0398,11479.0
1543,2011,MK11 1,MK11 1,Total,5893,2869,3024,5838,55,80,210.91,27.9,-0.847031,52.0544,5961.0
1544,2011,MK11 2,MK11 2,Total,1843,907,936,1833,10,18,41.69,44.2,-0.831578,52.0491,1775.0
1545,2011,MK12 5,MK12 5,Total,7779,3886,3893,7763,16,74,476.05,16.3,-0.818081,52.0594,7919.0
1546,2011,MK12 6,MK12 6,Total,4713,2262,2451,4713,0,27,196.6,24.0,-0.817823,52.0514,4561.0
1547,2011,MK13 0,MK13 0,Total,4475,2226,2249,4475,0,47,207.75,21.5,-0.799831,52.0578,4760.0
1548,2011,MK13 7,MK13 7,Total,7893,3866,4027,7893,0,70,195.3,40.4,-0.785213,52.0556,7761.0
1549,2011,MK13 8,MK13 8,Total,3466,1838,1628,3457,9,70,115.38,30.0,-0.783486,52.045,3315.0
1550,2011,MK13 9,MK13 9,Total,3026,1479,1547,3026,0,40,82.63,36.6,-0.791106,52.0481,2903.0
1551,2011,MK14 5,MK14 5,Total,6796,3305,3491,6685,111,132,305.24,22.3,-0.768043,52.0664,6932.0
1552,2011,MK14 6,MK14 6,Total,6047,2897,3150,5997,50,64,467.06,12.9,-0.774482,52.0588,6069.0
1553,2011,MK14 7,MK14 7,Total,5857,2960,2897,5806,51,76,123.98,47.2,-0.761573,52.0513,5719.0
1554,2011,MK15 0,MK15 0,Total,1165,605,560,1135,30,22,259.56,4.5,-0.720644,52.0452,956.0
1555,2011,MK15 8,MK15 8,Total,1870,891,979,1870,0,31,129.21,14.5,-0.730775,52.0613,1870.0
1556,2011,MK15 9,MK15 9,Total,4170,2026,2144,4155,15,89,213.74,19.5,-0.726248,52.0571,4314.0
1557,2011,MK16 0,MK16 0,Total,5506,2689,2817,5505,1,99,1505.07,3.7,-0.723301,52.0794,5892.0
1558,2011,MK16 8,MK16 8,Total,8088,3861,4227,7919,169,127,2300.87,3.5,-0.739126,52.0916,7879.0
1559,2011,MK16 9,MK16 9,Total,4906,2438,2468,4860,46,88,3954.08,1.2,-0.698439,52.0934,4851.0
1560,2011,MK17 0,MK17 0,Total,6135,3056,3079,6031,104,167,8170.2,0.8,-0.80698,51.979,6113.0
1561,2011,MK17 8,MK17 8,Total,6685,3272,3413,6587,98,124,2620.72,2.6,-0.653284,52.0212,6703.0
1562,2011,MK17 9,MK17 9,Total,4409,2141,2268,4392,17,84,6935.42,0.6,-0.65696,51.9845,4439.0
1563,2011,MK18 1,MK18 1,Total,9331,4627,4704,8856,475,199,1009.26,9.2,-0.985063,52.0008,9547.0
1564,2011,MK18 2,MK18 2,Total,5993,2973,3020,5993,0,164,6965.33,0.9,-0.961281,51.9521,5688.0
1565,2011,MK18 3,MK18 3,Total,5922,2868,3054,5871,51,149,3830.24,1.5,-0.888981,51.9423,5991.0
1566,2011,MK18 4,MK18 4,Total,3574,1743,1831,3542,32,82,5692.7,0.6,-1.03398,51.9776,3693.0
1567,2011,MK18 5,MK18 5,Total,2284,1255,1029,1657,627,126,5754.96,0.4,-0.993857,52.0303,2288.0
1568,2011,MK18 7,MK18 7,Total,3559,1751,1808,3559,0,78,576.21,6.2,-0.975364,51.9959,3329.0
1569,2011,MK19 6,MK19 6,Total,6489,3229,3260,6488,1,97,3696.43,1.8,-0.872983,52.0519,6468.0
1570,2011,MK19 7,MK19 7,Total,4769,2356,2413,4768,1,77,4501.85,1.1,-0.827978,52.0931,4736.0
1571,2011,MK40 1,MK40 1,Total,3641,1985,1656,3519,122,29,69.66,52.3,-0.470927,52.1368,3658.0
1572,2011,MK40 2,MK40 2,Total,7278,3804,3474,6079,1199,104,290.68,25.0,-0.472097,52.1407,7267.0
1573,2011,MK40 3,MK40 3,Total,8351,4107,4244,8058,293,154,150.57,55.5,-0.458175,52.1381,8334.0
1574,2011,MK40 4,MK40 4,Total,11739,5865,5874,11713,26,233,716.11,16.4,-0.495295,52.1348,11749.0
1575,2011,MK41 0,MK41 0,Total,9535,4529,5006,9502,33,115,1264.37,7.5,-0.426028,52.1483,9448.0
1576,2011,MK41 6,MK41 6,Total,4560,2161,2399,4381,179,55,839.34,5.4,-0.494952,52.1638,4574.0
1577,2011,MK41 7,MK41 7,Total,12153,6023,6130,12061,92,172,387.69,31.3,-0.465932,52.1534,12002.0
1578,2011,MK41 8,MK41 8,Total,7932,3867,4065,7908,24,149,249.93,31.7,-0.443512,52.1535,7428.0
1579,2011,MK41 9,MK41 9,Total,8357,4001,4356,7861,496,133,229.92,36.3,-0.443632,52.1421,9047.0
1580,2011,MK42 0,MK42 0,Total,12215,5902,6313,12165,50,77,546.05,22.4,-0.447262,52.1214,11859.0
1581,2011,MK42 6,MK42 6,Total,976,458,518,947,29,10,272.51,3.6,-0.462645,52.0897,838.0
1582,2011,MK42 7,MK42 7,Total,8460,4083,4377,8424,36,86,677.09,12.5,-0.497149,52.1137,8187.0
1583,2011,MK42 8,MK42 8,Total,10425,5074,5351,10330,95,115,237.34,43.9,-0.490077,52.1221,10625.0
1584,2011,MK42 9,MK42 9,Total,12482,6135,6347,12471,11,116,823.75,15.2,-0.468708,52.1233,12842.0
1585,2011,MK43 0,MK43 0,Total,12222,6302,5920,11603,619,161,6021.77,2.0,-0.576075,52.0631,12122.0
1586,2011,MK43 7,MK43 7,Total,7357,3608,3749,7313,44,163,5995.72,1.2,-0.553483,52.1826,7346.0
1587,2011,MK43 8,MK43 8,Total,7180,3530,3650,7142,38,186,4879.38,1.5,-0.550691,52.1444,7223.0
1588,2011,MK43 9,MK43 9,Total,6224,3084,3140,6223,1,89,2225.74,2.8,-0.517619,52.0953,6178.0
1589,2011,MK44 1,MK44 1,Total,5230,2536,2694,5154,76,175,6813.5,0.8,-0.513715,52.2243,5236.0
1590,2011,MK44 2,MK44 2,Total,3473,1717,1756,3452,21,90,8541.57,0.4,-0.423375,52.2075,3644.0
1591,2011,MK44 3,MK44 3,Total,6614,3249,3365,6577,37,118,7190.56,0.9,-0.367177,52.1481,6576.0
1592,2011,MK45 1,MK45 1,Total,12664,6352,6312,12626,38,224,842.49,15.0,-0.499102,52.0091,12664.0
1593,2011,MK45 2,MK45 2,Total,10307,5049,5258,10275,32,221,2548.88,4.0,-0.484293,52.0363,10306.0
1594,2011,MK45 3,MK45 3,Total,5845,2855,2990,5845,0,84,4229.7,1.4,-0.453428,52.0831,6014.0
1595,2011,MK45 4,MK45 4,Total,9116,4474,4642,9079,37,199,3601.24,2.5,-0.429296,52.011,9359.0
1596,2011,MK45 5,MK45 5,Total,5117,2592,2525,5080,37,102,2538.71,2.0,-0.483691,52.0054,4934.0
1597,2011,MK46 4,MK46 4,Total,3081,1468,1613,3042,39,55,1477.26,2.1,-0.681587,52.1564,3242.0
1598,2011,MK46 5,MK46 5,Total,6045,2955,3090,5985,60,148,4792.93,1.3,-0.705168,52.1509,5863.0
1599,2011,NE10 0,NE10 0,Total,8892,4366,4526,8833,59,47,433.47,20.5,-1.55959,54.9552,8466.0
1600,2011,NE10 8,NE10 8,Total,17836,8647,9189,17836,0,83,657.01,27.1,-1.54361,54.9433,18087.0
1601,2011,NE10 9,NE10 9,Total,9493,4545,4948,9400,93,35,225.28,42.1,-1.57053,54.9466,9583.0
1602,2011,NE11 0,NE11 0,Total,4185,2027,2158,4146,39,22,2092.37,2.0,-1.61974,54.9303,4005.0
1603,2011,NE11 9,NE11 9,Total,12274,5951,6323,12238,36,64,442.88,27.7,-1.64466,54.9506,12452.0
1604,2011,NE12 5,NE12 5,Total,1914,934,980,1909,5,1,54.15,35.3,-1.57838,55.0398,1843.0
1605,2011,NE12 6,NE12 6,Total,8685,4222,4463,8685,0,55,362.18,24.0,-1.56596,55.032,8862.0
1606,2011,NE12 7,NE12 7,Total,5005,2376,2629,4977,28,24,267.75,18.7,-1.57383,55.0261,5240.0
1607,2011,NE12 8,NE12 8,Total,9991,4806,5185,9938,53,72,294.53,33.9,-1.58361,55.0141,9954.0
1608,2011,NE12 9,NE12 9,Total,9501,4565,4936,9348,153,76,523.78,18.1,-1.55527,55.0208,8760.0
1609,2011,NE13 6,NE13 6,Total,5547,2603,2944,5502,45,52,2881.75,1.9,-1.6288,55.0515,5509.0
1610,2011,NE13 7,NE13 7,Total,5294,2532,2762,5272,22,44,1715.27,3.1,-1.6513,55.0442,5420.0
1611,2011,NE13 8,NE13 8,Total,1069,512,557,1069,0,22,733.77,1.5,-1.68837,55.0231,736.0
1612,2011,NE13 9,NE13 9,Total,941,479,462,941,0,4,385.4,2.4,-1.65019,55.0285,807.0
1613,2011,NE15 0,NE15 0,Total,2347,1232,1115,2181,166,35,3520.28,0.7,-1.81722,54.9976,2212.0
1614,2011,NE15 6,NE15 6,Total,5961,2858,3103,5891,70,27,242.42,24.6,-1.67862,54.9722,6272.0
1615,2011,NE15 7,NE15 7,Total,9328,4545,4783,9268,60,50,335.54,27.8,-1.69265,54.9809,9211.0
1616,2011,NE15 8,NE15 8,Total,8829,4262,4567,8776,53,31,575.05,15.4,-1.7222,54.9823,8391.0
1617,2011,NE15 9,NE15 9,Total,6226,3020,3206,6136,90,25,526.8,11.8,-1.74589,54.993,6483.0
1618,2011,NE16 3,NE16 3,Total,3335,1648,1687,3276,59,22,209.54,15.9,-1.68517,54.9549,3175.0
1619,2011,NE16 4,NE16 4,Total,6424,3148,3276,6346,78,58,305.53,21.0,-1.67783,54.9457,6779.0
1620,2011,NE16 5,NE16 5,Total,10913,5294,5619,10908,5,117,1565.97,7.0,-1.68616,54.9339,10600.0
1621,2011,NE16 6,NE16 6,Total,5002,2477,2525,4941,61,51,965.65,5.2,-1.72971,54.9083,5117.0
1622,2011,NE17 7,NE17 7,Total,4669,2303,2366,4622,47,46,605.34,7.7,-1.81819,54.9145,4890.0
1623,2011,NE18 0,NE18 0,Total,927,447,480,924,3,19,3993.16,0.2,-1.8604,55.0386,959.0
1624,2011,NE19 1,NE19 1,Total,1240,634,606,1219,21,26,28568.68,0.0,-2.19889,55.2537,1246.0
1625,2011,NE19 2,NE19 2,Total,1033,498,535,1033,0,34,13323.2,0.1,-1.99243,55.1062,913.0
1626,2011,NE20 0,NE20 0,Total,1426,704,722,1353,73,31,11081.51,0.1,-1.83547,55.0669,1655.0
1627,2011,NE20 9,NE20 9,Total,10447,5070,5377,10388,59,246,2803.78,3.7,-1.75133,55.044,10183.0
1628,2011,NE21 4,NE21 4,Total,5620,2670,2950,5526,94,24,264.39,21.3,-1.72543,54.9646,5793.0
1629,2011,NE21 5,NE21 5,Total,5350,2587,2763,5330,20,29,379.98,14.1,-1.71052,54.9597,5100.0
1630,2011,NE21 6,NE21 6,Total,6306,3054,3252,6260,46,47,793.44,7.9,-1.72632,54.9518,6367.0
1631,2011,NE22 5,NE22 5,Total,8937,4312,4625,8872,65,46,620.84,14.4,-1.57976,55.1353,8610.0
1632,2011,NE22 6,NE22 6,Total,5657,2751,2906,5652,5,59,932.75,6.1,-1.60478,55.1347,6029.0
1633,2011,NE22 7,NE22 7,Total,3290,1610,1680,3174,116,29,377.47,8.7,-1.56678,55.1439,3524.0
1634,2011,NE23 1,NE23 1,Total,3745,1796,1949,3604,141,31,363.82,10.3,-1.59156,55.0922,3777.0
1635,2011,NE23 2,NE23 2,Total,5826,2767,3059,5826,0,42,131.95,44.2,-1.57515,55.0903,5657.0
1636,2011,NE23 3,NE23 3,Total,5710,2799,2911,5710,0,82,409.97,13.9,-1.58493,55.0998,5833.0
1637,2011,NE23 6,NE23 6,Total,10745,5128,5617,10597,148,68,428.43,25.1,-1.58175,55.079,10702.0
1638,2011,NE23 7,NE23 7,Total,10580,5138,5442,10526,54,55,1069.34,9.9,-1.57781,55.0611,10614.0
1639,2011,NE23 8,NE23 8,Total,2627,1285,1342,2583,44,15,892.58,2.9,-1.60855,55.0865,2668.0
1640,2011,NE24 1,NE24 1,Total,3565,1714,1851,3532,33,19,416.0,8.6,-1.51627,55.133,3549.0
1641,2011,NE24 2,NE24 2,Total,6252,3036,3216,6122,130,29,113.8,54.9,-1.51232,55.1235,5876.0
1642,2011,NE24 3,NE24 3,Total,11064,5460,5604,11064,0,70,426.35,26.0,-1.50943,55.1163,11262.0
1643,2011,NE24 4,NE24 4,Total,7700,3766,3934,7607,93,36,1037.93,7.4,-1.54024,55.1175,7614.0
1644,2011,NE24 5,NE24 5,Total,9495,4561,4934,9375,120,30,271.71,34.9,-1.5317,55.1261,9645.0
1645,2011,NE25 0,NE25 0,Total,9350,4562,4788,9306,44,38,1494.61,6.3,-1.52053,55.0711,9320.0
1646,2011,NE25 8,NE25 8,Total,9169,4388,4781,9132,37,115,209.68,43.7,-1.46374,55.036,9318.0
1647,2011,NE25 9,NE25 9,Total,11289,5413,5876,11183,106,143,374.93,30.1,-1.4806,55.0404,11306.0
1648,2011,NE26 1,NE26 1,Total,5264,2601,2663,5133,131,73,104.09,50.6,-1.45715,55.0457,5234.0
1649,2011,NE26 2,NE26 2,Total,4523,2274,2249,4339,184,54,66.96,67.5,-1.44414,55.04,4268.0
1650,2011,NE26 3,NE26 3,Total,5275,2535,2740,5265,10,108,328.29,16.1,-1.46235,55.0459,5397.0
1651,2011,NE26 4,NE26 4,Total,4264,2040,2224,4236,28,44,983.29,4.3,-1.47569,55.0772,4270.0
1652,2011,NE27 0,NE27 0,Total,12024,5751,6273,11981,43,65,1117.08,10.8,-1.51347,55.0325,12335.0
1653,2011,NE28 0,NE28 0,Total,8701,4154,4547,8586,115,32,243.03,35.8,-1.49604,55.0004,8424.0
1654,2011,NE28 6,NE28 6,Total,5201,2600,2601,5159,42,18,248.47,20.9,-1.5159,54.9924,5269.0
1655,2011,NE28 7,NE28 7,Total,8007,3928,4079,7936,71,38,222.91,35.9,-1.51755,54.9985,8246.0
1656,2011,NE28 8,NE28 8,Total,9635,4671,4964,9634,1,42,278.95,34.5,-1.54061,54.9974,9663.0
1657,2011,NE28 9,NE28 9,Total,13205,6273,6932,13150,55,71,414.53,31.9,-1.52251,55.0092,13059.0
1658,2011,NE29 0,NE29 0,Total,6582,3152,3430,6408,174,42,114.66,57.4,-1.45599,55.0104,6503.0
1659,2011,NE29 6,NE29 6,Total,7712,3976,3736,7641,71,21,310.66,24.8,-1.45881,55.0031,7914.0
1660,2011,NE29 7,NE29 7,Total,8361,3950,4411,8356,5,36,243.12,34.4,-1.47529,55.0077,8207.0
1661,2011,NE29 8,NE29 8,Total,8812,4206,4606,8812,0,54,412.64,21.4,-1.48089,55.0198,8779.0
1662,2011,NE29 9,NE29 9,Total,4146,1993,2153,4020,126,42,105.2,39.4,-1.45965,55.021,4585.0
1663,2011,NE30 1,NE30 1,Total,1317,635,682,1317,0,2,33.92,38.8,-1.44317,55.0098,1313.0
1664,2011,NE30 2,NE30 2,Total,7761,3721,4040,7676,85,99,197.7,39.3,-1.44527,55.0181,7796.0
1665,2011,NE30 3,NE30 3,Total,8303,3961,4342,8303,0,96,178.23,46.6,-1.44652,55.0293,8160.0
1666,2011,NE30 4,NE30 4,Total,4952,2409,2543,4887,65,46,143.98,34.4,-1.43519,55.0216,4737.0
1667,2011,NE31 1,NE31 1,Total,10260,4982,5278,10128,132,43,332.8,30.8,-1.51613,54.9759,10617.0
1668,2011,NE31 2,NE31 2,Total,9870,4723,5147,9771,99,44,308.52,32.0,-1.50919,54.9666,9542.0
1669,2011,NE32 3,NE32 3,Total,5327,2552,2775,5180,147,22,367.95,14.5,-1.48128,54.9782,5268.0
1670,2011,NE32 4,NE32 4,Total,10419,5012,5407,10411,8,42,300.85,34.6,-1.481,54.9577,10419.0
1671,2011,NE32 5,NE32 5,Total,9643,4693,4950,9541,102,61,291.21,33.1,-1.49065,54.9713,9672.0
1672,2011,NE33 1,NE33 1,Total,1316,672,644,1314,2,6,98.54,13.4,-1.43662,54.9962,1234.0
1673,2011,NE33 2,NE33 2,Total,6229,3095,3134,6041,188,49,143.27,43.5,-1.42758,54.9993,6157.0
1674,2011,NE33 3,NE33 3,Total,7866,3929,3937,7565,301,49,151.08,52.1,-1.42017,54.9908,7963.0
1675,2011,NE33 4,NE33 4,Total,7324,3682,3642,7234,90,30,126.41,57.9,-1.4308,54.9859,7608.0
1676,2011,NE33 5,NE33 5,Total,4334,2300,2034,4314,20,23,135.28,32.0,-1.44004,54.9851,4414.0
1677,2011,NE34 0,NE34 0,Total,10653,5102,5551,10510,143,49,220.43,48.3,-1.43313,54.975,10419.0
1678,2011,NE34 6,NE34 6,Total,9264,4392,4872,9248,16,70,189.33,48.9,-1.40962,54.98,8887.0
1679,2011,NE34 7,NE34 7,Total,11667,5483,6184,11566,101,50,283.33,41.2,-1.39653,54.9782,11865.0
1680,2011,NE34 8,NE34 8,Total,10126,4857,5269,10084,42,54,288.4,35.1,-1.41988,54.9653,10271.0
1681,2011,NE34 9,NE34 9,Total,10769,5041,5728,10762,7,43,274.14,39.3,-1.45172,54.9667,10778.0
1682,2011,NE35 9,NE35 9,Total,6428,3152,3276,6428,0,41,270.91,23.7,-1.46233,54.9523,6371.0
1683,2011,NE36 0,NE36 0,Total,6854,3249,3605,6854,0,71,1579.01,4.3,-1.44175,54.9463,6839.0
1684,2011,NE37 1,NE37 1,Total,9759,4743,5016,9696,63,48,370.93,26.3,-1.53797,54.9084,9721.0
1685,2011,NE37 2,NE37 2,Total,7202,3355,3847,7146,56,38,205.54,35.0,-1.52405,54.9143,7244.0
1686,2011,NE37 3,NE37 3,Total,4095,2076,2019,4095,0,16,953.41,4.3,-1.51258,54.9149,4069.0
1687,2011,NE38 0,NE38 0,Total,9145,4523,4622,9140,5,53,282.2,32.4,-1.54429,54.8958,9086.0
1688,2011,NE38 7,NE38 7,Total,9000,4379,4621,8988,12,48,287.82,31.3,-1.52248,54.899,8908.0
1689,2011,NE38 8,NE38 8,Total,7820,3800,4020,7783,37,68,574.01,13.6,-1.50928,54.8952,8020.0
1690,2011,NE38 9,NE38 9,Total,5136,2512,2624,5134,2,62,233.11,22.0,-1.54203,54.8843,5218.0
1691,2011,NE39 1,NE39 1,Total,3968,1914,2054,3965,3,51,338.68,11.7,-1.74931,54.922,3914.0
1692,2011,NE39 2,NE39 2,Total,4607,2181,2426,4541,66,45,1606.06,2.9,-1.76749,54.9289,4741.0
1693,2011,NE40 3,NE40 3,Total,7629,3650,3979,7596,33,90,446.71,17.1,-1.76081,54.9717,7927.0
1694,2011,NE40 4,NE40 4,Total,8006,3845,4161,7906,100,59,853.22,9.4,-1.78134,54.9609,7826.0
1695,2011,NE41 8,NE41 8,Total,2197,1065,1132,2164,33,52,1038.73,2.1,-1.82163,54.9756,2076.0
1696,2011,NE42 5,NE42 5,Total,6974,3379,3595,6894,80,56,741.11,9.4,-1.84394,54.9604,6582.0
1697,2011,NE42 6,NE42 6,Total,5633,2689,2944,5585,48,90,765.34,7.4,-1.86558,54.9639,6061.0
1698,2011,NE43 7,NE43 7,Total,4523,2197,2326,4415,108,117,5639.75,0.8,-1.90189,54.9494,4533.0
1699,2011,NE44 6,NE44 6,Total,966,448,518,925,41,25,756.8,1.3,-1.98044,54.944,1074.0
1700,2011,NE45 5,NE45 5,Total,3672,1743,1929,3556,116,89,4149.37,0.9,-2.01856,54.9766,3707.0
1701,2011,NE46 1,NE46 1,Total,4198,1961,2237,3939,259,73,2652.64,1.6,-2.09291,54.9642,4088.0
1702,2011,NE46 2,NE46 2,Total,4459,2113,2346,4375,84,127,1665.37,2.7,-2.11993,54.9643,4773.0
1703,2011,NE46 3,NE46 3,Total,3510,1687,1823,3494,16,92,170.86,20.5,-2.10962,54.9736,3526.0
1704,2011,NE46 4,NE46 4,Total,3370,1696,1674,3311,59,77,10736.18,0.3,-2.109,55.0096,3186.0
1705,2011,NE47 0,NE47 0,Total,1070,539,531,1030,40,24,10197.91,0.1,-2.0811,54.9082,942.0
1706,2011,NE47 5,NE47 5,Total,906,452,454,906,0,11,2390.42,0.4,-2.22053,54.9857,1127.0
1707,2011,NE47 6,NE47 6,Total,2184,1076,1108,2154,30,52,7129.36,0.3,-2.24684,54.9783,1995.0
1708,2011,NE47 7,NE47 7,Total,1214,609,605,1158,56,34,8680.7,0.1,-2.34588,54.979,1189.0
1709,2011,NE47 8,NE47 8,Total,522,264,258,492,30,13,11382.06,0.0,-2.33039,54.8857,454.0
1710,2011,NE47 9,NE47 9,Total,2021,996,1025,2007,14,50,10853.55,0.2,-2.25127,54.8778,2027.0
1711,2011,NE48 1,NE48 1,Total,764,383,381,764,0,24,43683.76,0.0,-2.43591,55.1891,775.0
1712,2011,NE48 2,NE48 2,Total,1852,921,931,1850,2,30,10349.24,0.2,-2.21742,55.1499,1852.0
1713,2011,NE48 3,NE48 3,Total,1105,557,548,1105,0,17,17262.58,0.1,-2.22497,55.0855,1194.0
1714,2011,NE48 4,NE48 4,Total,573,275,298,573,0,30,2019.2,0.3,-2.12366,55.0655,566.0
1715,2011,NE49 0,NE49 0,Total,1085,526,559,1079,6,18,6063.4,0.2,-2.46063,54.9586,1225.0
1716,2011,NE49 9,NE49 9,Total,3259,1606,1653,3250,9,38,1224.45,2.7,-2.46094,54.9749,3178.0
1717,2011,NE61 1,NE61 1,Total,4134,1988,2146,3738,396,65,408.76,10.1,-1.68857,55.1684,3952.0
1718,2011,NE61 2,NE61 2,Total,8928,4299,4629,8879,49,170,525.01,17.0,-1.68921,55.1605,9030.0
1719,2011,NE61 3,NE61 3,Total,3853,1908,1945,3853,0,95,13467.36,0.3,-1.71786,55.1814,3652.0
1720,2011,NE61 4,NE61 4,Total,1260,628,632,1244,16,30,19712.21,0.1,-1.90365,55.1859,1115.0
1721,2011,NE61 5,NE61 5,Total,8080,3999,4081,8014,66,86,4335.07,1.9,-1.58194,55.2324,9257.0
1722,2011,NE61 6,NE61 6,Total,5014,2469,2545,4967,47,66,3145.48,1.6,-1.66389,55.1539,5462.0
1723,2011,NE62 5,NE62 5,Total,9636,4623,5013,9542,94,66,1167.39,8.3,-1.59284,55.1613,9507.0
1724,2011,NE63 0,NE63 0,Total,8147,3989,4158,8136,11,46,264.2,30.8,-1.56094,55.1748,7889.0
1725,2011,NE63 8,NE63 8,Total,8490,4140,4350,8385,105,102,1361.93,6.2,-1.57857,55.1785,8450.0
1726,2011,NE63 9,NE63 9,Total,11152,5477,5675,11052,100,56,732.73,15.2,-1.55223,55.1798,11396.0
1727,2011,NE64 6,NE64 6,Total,6308,3034,3274,6242,66,30,864.92,7.3,-1.51665,55.184,6248.0
1728,2011,NE65 0,NE65 0,Total,7878,3833,4045,7808,70,89,2988.23,2.6,-1.59527,55.3301,7907.0
1729,2011,NE65 7,NE65 7,Total,3889,1914,1975,3861,28,69,39117.78,0.1,-1.95867,55.3173,3773.0
1730,2011,NE65 8,NE65 8,Total,2141,1024,1117,2138,3,53,6657.34,0.3,-1.79285,55.2725,2317.0
1731,2011,NE65 9,NE65 9,Total,6856,3849,3007,5741,1115,82,10528.29,0.7,-1.67233,55.3029,5674.0
1732,2011,NE66 1,NE66 1,Total,6766,3206,3560,6664,102,81,1744.83,3.9,-1.70763,55.4105,6529.0
1733,2011,NE66 2,NE66 2,Total,4244,2074,2170,4093,151,62,15568.13,0.3,-1.71236,55.4047,4581.0
1734,2011,NE66 3,NE66 3,Total,4720,2359,2361,4463,257,74,9787.08,0.5,-1.63474,55.4522,4547.0
1735,2011,NE66 4,NE66 4,Total,1522,748,774,1522,0,36,22890.0,0.1,-1.92107,55.4328,1527.0
1736,2011,NE66 5,NE66 5,Total,338,168,170,337,1,11,4675.87,0.1,-1.9085,55.5506,295.0
1737,2011,NE67 5,NE67 5,Total,834,423,411,831,3,25,4986.69,0.2,-1.69381,55.5343,969.0
1738,2011,NE68 7,NE68 7,Total,1959,953,1006,1952,7,16,790.33,2.5,-1.66056,55.5722,1975.0
1739,2011,NE69 7,NE69 7,Total,414,196,218,411,3,5,1445.21,0.3,-1.71881,55.605,417.0
1740,2011,NE70 7,NE70 7,Total,1754,876,878,1751,3,33,8758.4,0.2,-1.81616,55.592,1813.0
1741,2011,NE71 6,NE71 6,Total,2949,1410,1539,2927,22,30,26789.45,0.1,-2.04084,55.553,2966.0
1742,2011,NG10 1,NG10 1,Total,7938,3963,3975,7899,39,42,213.66,37.2,-1.27217,52.8936,8044.0
1743,2011,NG10 2,NG10 2,Total,4613,2319,2294,4565,48,38,446.05,10.3,-1.26249,52.8969,4552.0
1744,2011,NG10 3,NG10 3,Total,14380,7075,7305,14373,7,148,536.97,26.8,-1.292,52.8873,14596.0
1745,2011,NG10 4,NG10 4,Total,10829,5303,5526,10637,192,90,254.65,42.5,-1.28499,52.9039,10791.0
1746,2011,NG10 5,NG10 5,Total,8889,4305,4584,8803,86,77,444.87,20.0,-1.29015,52.9194,8899.0
1747,2011,NG11 0,NG11 0,Total,2431,1196,1235,2431,0,34,3213.11,0.8,-1.21524,52.871,2395.0
1748,2011,NG11 6,NG11 6,Total,8233,3990,4243,8087,146,154,2543.35,3.2,-1.15245,52.8913,8316.0
1749,2011,NG11 7,NG11 7,Total,4428,2186,2242,4428,0,61,153.06,28.9,-1.16141,52.9225,4495.0
1750,2011,NG11 8,NG11 8,Total,13340,6485,6855,12562,778,109,560.9,23.8,-1.18111,52.9069,13201.0
1751,2011,NG11 9,NG11 9,Total,9067,4403,4664,9058,9,41,181.54,49.9,-1.18165,52.8991,9207.0
1752,2011,NG12 1,NG12 1,Total,2527,1234,1293,2506,21,34,1057.08,2.4,-1.03686,52.956,2688.0
1753,2011,NG12 2,NG12 2,Total,6537,3130,3407,6381,156,113,1791.15,3.6,-1.04612,52.9451,6258.0
1754,2011,NG12 3,NG12 3,Total,10862,5321,5541,10697,165,141,6064.84,1.8,-1.02597,52.9116,10726.0
1755,2011,NG12 4,NG12 4,Total,4857,2413,2444,4857,0,101,1407.07,3.5,-1.11331,52.912,4740.0
1756,2011,NG12 5,NG12 5,Total,8382,4099,4283,8320,62,156,3998.69,2.1,-1.08431,52.8718,8504.0
1757,2011,NG13 0,NG13 0,Total,4508,2185,2323,4508,0,71,4633.21,1.0,-0.819645,52.9324,4537.0
1758,2011,NG13 8,NG13 8,Total,11712,5648,6064,11664,48,193,4217.1,2.8,-0.975181,52.9567,11820.0
1759,2011,NG13 9,NG13 9,Total,5164,2949,2215,4306,858,84,7374.76,0.7,-0.92728,52.9437,5118.0
1760,2011,NG14 5,NG14 5,Total,3922,1905,2017,3911,11,62,1375.25,2.9,-1.03979,52.9859,3932.0
1761,2011,NG14 6,NG14 6,Total,9537,4621,4916,9471,66,134,4131.18,2.3,-1.07302,53.0322,9408.0
1762,2011,NG14 7,NG14 7,Total,5980,3342,2638,5052,928,115,3425.95,1.7,-0.999551,53.0099,6035.0
1763,2011,NG15 0,NG15 0,Total,2076,1019,1057,2059,17,21,1973.01,1.1,-1.2286,53.0637,1821.0
1764,2011,NG15 6,NG15 6,Total,14763,7288,7475,14648,115,117,956.47,15.4,-1.21979,53.0299,14795.0
1765,2011,NG15 7,NG15 7,Total,12829,6236,6593,12655,174,76,486.56,26.4,-1.20163,53.0355,12595.0
1766,2011,NG15 8,NG15 8,Total,5271,2568,2703,5210,61,55,1557.65,3.4,-1.19495,53.0473,5261.0
1767,2011,NG15 9,NG15 9,Total,5759,2802,2957,5756,3,123,1464.37,3.9,-1.16605,53.0833,5641.0
1768,2011,NG16 1,NG16 1,Total,9349,4623,4726,9332,17,122,949.45,9.8,-1.24861,52.9985,9597.0
1769,2011,NG16 2,NG16 2,Total,16473,8164,8309,16439,34,145,1733.53,9.5,-1.28009,53.0031,16039.0
1770,2011,NG16 3,NG16 3,Total,10812,5338,5474,10667,145,72,1014.77,10.7,-1.30417,53.0174,11017.0
1771,2011,NG16 4,NG16 4,Total,5405,2646,2759,5405,0,31,717.02,7.5,-1.33362,53.0221,5471.0
1772,2011,NG16 5,NG16 5,Total,10047,4928,5119,9988,59,66,1527.18,6.6,-1.322,53.052,10117.0
1773,2011,NG16 6,NG16 6,Total,11465,5698,5767,11354,111,52,1186.45,9.7,-1.31007,53.0764,11456.0
1774,2011,NG17 1,NG17 1,Total,6439,3203,3236,6374,65,48,243.95,26.4,-1.27285,53.1206,6425.0
1775,2011,NG17 2,NG17 2,Total,14585,7071,7514,14287,298,88,744.35,19.6,-1.28514,53.1274,14295.0
1776,2011,NG17 3,NG17 3,Total,8900,4362,4538,8857,43,57,1671.09,5.3,-1.26793,53.1417,8799.0
1777,2011,NG17 4,NG17 4,Total,9768,4918,4850,9664,104,48,232.28,42.1,-1.25111,53.1307,9803.0
1778,2011,NG17 5,NG17 5,Total,6475,3149,3326,6475,0,31,458.49,14.1,-1.25173,53.1201,6873.0
1779,2011,NG17 7,NG17 7,Total,9204,4499,4705,9060,144,56,869.04,10.6,-1.24056,53.1007,9324.0
1780,2011,NG17 8,NG17 8,Total,11236,5523,5713,11177,59,99,1083.09,10.4,-1.25852,53.1022,11111.0
1781,2011,NG17 9,NG17 9,Total,6179,3058,3121,6159,20,33,457.73,13.5,-1.25411,53.0827,6263.0
1782,2011,NG18 1,NG18 1,Total,1438,743,695,1354,84,12,75.68,19.0,-1.19786,53.1447,1371.0
1783,2011,NG18 2,NG18 2,Total,7952,3967,3985,7777,175,48,229.36,34.7,-1.18543,53.1455,8028.0
1784,2011,NG18 3,NG18 3,Total,11644,5710,5934,11597,47,101,542.87,21.4,-1.16364,53.1408,11434.0
1785,2011,NG18 4,NG18 4,Total,12656,6242,6414,12486,170,164,1590.51,8.0,-1.178,53.1312,12600.0
1786,2011,NG18 5,NG18 5,Total,7836,3895,3941,7743,93,75,316.69,24.7,-1.20797,53.1387,8848.0
1787,2011,NG19 0,NG19 0,Total,11328,5515,5813,11260,68,109,522.01,21.7,-1.16125,53.1552,11260.0
1788,2011,NG19 6,NG19 6,Total,11773,5702,6071,11702,71,57,305.79,38.5,-1.22041,53.1477,11317.0
1789,2011,NG19 7,NG19 7,Total,9163,4471,4692,9032,131,77,964.14,9.5,-1.22143,53.1609,8958.0
1790,2011,NG19 8,NG19 8,Total,10182,4965,5217,10108,74,76,1088.96,9.4,-1.20222,53.1718,10314.0
1791,2011,NG19 9,NG19 9,Total,9830,4873,4957,9819,11,125,428.26,23.0,-1.18238,53.1642,9814.0
1792,2011,NG20 0,NG20 0,Total,9264,4529,4735,9171,93,68,2129.39,4.4,-1.1528,53.2031,9195.0
1793,2011,NG20 8,NG20 8,Total,9976,4825,5151,9878,98,42,1113.3,9.0,-1.21539,53.2022,9947.0
1794,2011,NG20 9,NG20 9,Total,6950,3440,3510,6862,88,33,2192.73,3.2,-1.1831,53.2239,7105.0
1795,2011,NG21 0,NG21 0,Total,12150,5948,6202,11981,169,90,2578.12,4.7,-1.12022,53.1119,12177.0
1796,2011,NG21 9,NG21 9,Total,10031,4882,5149,9882,149,87,3494.8,2.9,-1.09132,53.1796,9941.0
1797,2011,NG22 0,NG22 0,Total,6804,3347,3457,6767,37,129,13192.88,0.5,-0.898275,53.2137,6639.0
1798,2011,NG22 8,NG22 8,Total,7649,3798,3851,7535,114,122,6450.32,1.2,-1.00898,53.1125,7761.0
1799,2011,NG22 9,NG22 9,Total,11840,5845,5995,11723,117,106,6097.92,1.9,-0.998927,53.2043,11756.0
1800,2011,NG23 5,NG23 5,Total,7164,3481,3683,7123,41,169,12187.02,0.6,-0.811193,53.0315,7212.0
1801,2011,NG23 6,NG23 6,Total,5345,2624,2721,5330,15,111,9023.71,0.6,-0.830668,53.1532,5523.0
1802,2011,NG23 7,NG23 7,Total,4736,2343,2393,4662,74,65,8399.13,0.6,-0.751576,53.1703,4700.0
1803,2011,NG24 1,NG24 1,Total,6771,3399,3372,6723,48,44,460.22,14.7,-0.806127,53.0764,7186.0
1804,2011,NG24 2,NG24 2,Total,10382,5133,5249,10296,86,135,2351.56,4.4,-0.78172,53.0824,10279.0
1805,2011,NG24 3,NG24 3,Total,13627,6659,6968,13565,62,139,3088.37,4.4,-0.791196,53.055,13533.0
1806,2011,NG24 4,NG24 4,Total,14025,6729,7296,13843,182,122,480.22,29.2,-0.815906,53.0665,13770.0
1807,2011,NG25 0,NG25 0,Total,8913,4208,4705,8548,365,239,5087.61,1.8,-0.95101,53.0741,8993.0
1808,2011,NG31 6,NG31 6,Total,3510,1754,1756,3455,55,23,127.26,27.6,-0.640687,52.9101,3828.0
1809,2011,NG31 7,NG31 7,Total,13714,6658,7056,13697,17,123,773.07,17.7,-0.648716,52.9046,13838.0
1810,2011,NG31 8,NG31 8,Total,13855,6676,7179,13639,216,271,2485.55,5.6,-0.653935,52.9224,13611.0
1811,2011,NG31 9,NG31 9,Total,13262,6405,6857,13087,175,145,1792.43,7.4,-0.622224,52.918,13002.0
1812,2011,NG32 1,NG32 1,Total,4215,2055,2160,4196,19,70,7881.43,0.5,-0.723073,52.8892,4497.0
1813,2011,NG32 2,NG32 2,Total,3505,1721,1784,3505,0,86,8102.22,0.4,-0.66544,52.9637,3670.0
1814,2011,NG32 3,NG32 3,Total,4708,2306,2402,4678,30,78,9099.96,0.5,-0.566719,52.992,4825.0
1815,2011,NG33 4,NG33 4,Total,4789,2342,2447,4789,0,138,15449.51,0.3,-0.529413,52.8272,4701.0
1816,2011,NG33 5,NG33 5,Total,5070,2541,2529,5069,1,76,11351.05,0.4,-0.636684,52.8152,5008.0
1817,2011,NG34 0,NG34 0,Total,5926,2848,3078,5895,31,102,15874.84,0.4,-0.370517,52.9137,5979.0
1818,2011,NG34 7,NG34 7,Total,12895,6202,6693,12775,120,171,845.29,15.3,-0.411543,52.9965,13093.0
1819,2011,NG34 8,NG34 8,Total,11199,5550,5649,10983,216,190,12480.96,0.9,-0.439926,53.0093,10767.0
1820,2011,NG34 9,NG34 9,Total,11182,5445,5737,11075,107,139,10934.98,1.0,-0.344174,53.0114,10990.0
1821,2011,NN10 0,NN10 0,Total,13451,6647,6804,13289,162,129,935.91,14.4,-0.590516,52.2878,13482.0
1822,2011,NN10 6,NN10 6,Total,5632,2763,2869,5493,139,57,406.25,13.9,-0.608711,52.2967,4928.0
1823,2011,NN10 8,NN10 8,Total,8083,3988,4095,8020,63,77,854.76,9.5,-0.595247,52.3065,8256.0
1824,2011,NN10 9,NN10 9,Total,11065,5450,5615,11015,50,85,898.58,12.3,-0.606333,52.2892,11611.0
1825,2011,NN11 0,NN11 0,Total,5373,2666,2707,5373,0,62,230.21,23.3,-1.16174,52.2727,5024.0
1826,2011,NN11 2,NN11 2,Total,1313,629,684,1313,0,42,2804.04,0.5,-1.13464,52.2792,1244.0
1827,2011,NN11 3,NN11 3,Total,6290,3124,3166,6232,58,151,9018.15,0.7,-1.18892,52.1914,6222.0
1828,2011,NN11 4,NN11 4,Total,11581,5681,5900,11400,181,100,871.11,13.3,-1.16006,52.2548,11630.0
1829,2011,NN11 6,NN11 6,Total,3054,1522,1532,3028,26,90,5408.2,0.6,-1.21336,52.1955,3130.0
1830,2011,NN11 7,NN11 7,Total,1759,862,897,1759,0,24,1318.26,1.3,-1.19327,52.2835,1751.0
1831,2011,NN11 8,NN11 8,Total,1488,752,736,1488,0,20,190.42,7.8,-1.17678,52.2741,1659.0
1832,2011,NN11 9,NN11 9,Total,6584,3249,3335,6584,0,45,177.73,37.0,-1.17108,52.264,6781.0
1833,2011,NN12 6,NN12 6,Total,7603,3773,3830,7570,33,120,1092.94,7.0,-0.986622,52.1261,7662.0
1834,2011,NN12 7,NN12 7,Total,6189,3079,3110,6125,64,131,4806.34,1.3,-0.956804,52.1184,6271.0
1835,2011,NN12 8,NN12 8,Total,9235,4650,4585,9155,80,285,14186.95,0.7,-1.03734,52.1368,9114.0
1836,2011,NN13 5,NN13 5,Total,5528,2764,2764,5425,103,156,12922.45,0.4,-1.1449,52.0318,5583.0
1837,2011,NN13 6,NN13 6,Total,10250,5126,5124,10146,104,195,1963.55,5.2,-1.15226,52.0362,9731.0
1838,2011,NN13 7,NN13 7,Total,2950,1443,1507,2908,42,39,160.76,18.4,-1.14376,52.029,3208.0
1839,2011,NN14 1,NN14 1,Total,10009,4881,5128,9990,19,162,8457.58,1.2,-0.747565,52.3997,10184.0
1840,2011,NN14 2,NN14 2,Total,10697,5251,5446,10549,148,113,967.53,11.1,-0.807989,52.4339,10760.0
1841,2011,NN14 3,NN14 3,Total,4349,2175,2174,4317,32,108,10929.44,0.4,-0.582506,52.4215,4167.0
1842,2011,NN14 4,NN14 4,Total,10520,5256,5264,10442,78,170,5264.21,2.0,-0.573524,52.3884,10462.0
1843,2011,NN14 6,NN14 6,Total,7694,3752,3942,7688,6,83,1372.17,5.6,-0.795099,52.4206,7634.0
1844,2011,NN15 5,NN15 5,Total,14736,7196,7540,14704,32,210,1478.11,10.0,-0.68709,52.3768,15105.0
1845,2011,NN15 6,NN15 6,Total,13282,6476,6806,13109,173,177,618.09,21.5,-0.711565,52.3846,12749.0
1846,2011,NN15 7,NN15 7,Total,5947,2927,3020,5872,75,90,215.86,27.6,-0.727127,52.3948,6601.0
1847,2011,NN16 0,NN16 0,Total,7566,3706,3860,7478,88,56,189.06,40.0,-0.71687,52.4011,7254.0
1848,2011,NN16 8,NN16 8,Total,7921,4037,3884,7792,129,64,257.26,30.8,-0.72951,52.4029,7547.0
1849,2011,NN16 9,NN16 9,Total,14656,7223,7433,14394,262,167,1483.23,9.9,-0.722042,52.4103,14921.0
1850,2011,NN17 1,NN17 1,Total,9666,4818,4848,9577,89,76,794.22,12.2,-0.690196,52.4936,9748.0
1851,2011,NN17 2,NN17 2,Total,12295,6014,6281,12239,56,93,277.83,44.3,-0.711214,52.5002,12325.0
1852,2011,NN17 3,NN17 3,Total,4163,2085,2078,4078,85,67,7794.29,0.5,-0.638922,52.5163,4034.0
1853,2011,NN17 4,NN17 4,Total,585,274,311,585,0,2,186.96,3.1,-0.690256,52.5052,541.0
1854,2011,NN18 0,NN18 0,Total,8803,4290,4513,8792,11,81,213.83,41.2,-0.719513,52.4863,9280.0
1855,2011,NN18 8,NN18 8,Total,14719,7317,7402,14669,50,135,2009.85,7.3,-0.698838,52.475,14391.0
1856,2011,NN18 9,NN18 9,Total,9389,4569,4820,9383,6,81,271.92,34.5,-0.71764,52.4777,9046.0
1857,2011,NN29 7,NN29 7,Total,11520,5717,5803,11378,142,130,6358.71,1.8,-0.665428,52.2627,11532.0
1858,2011,NR10 3,NR10 3,Total,10594,5227,5367,10435,159,99,3818.62,2.8,1.27826,52.6957,10524.0
1859,2011,NR10 4,NR10 4,Total,5573,2746,2827,5555,18,86,6839.72,0.8,1.14857,52.753,5559.0
1860,2011,NR10 5,NR10 5,Total,6645,3625,3020,6023,622,63,6322.77,1.1,1.30783,52.7635,6678.0
1861,2011,NR11 6,NR11 6,Total,7772,3726,4046,7703,69,122,8226.56,0.9,1.23247,52.7988,7649.0
1862,2011,NR11 7,NR11 7,Total,2976,1477,1499,2976,0,59,7912.33,0.4,1.23121,52.8505,3097.0
1863,2011,NR11 8,NR11 8,Total,6933,3361,3572,6851,82,121,6206.79,1.1,1.35875,52.8844,6790.0
1864,2011,NR12 0,NR12 0,Total,4503,2215,2288,4430,73,36,5583.9,0.8,1.53019,52.8058,4708.0
1865,2011,NR12 7,NR12 7,Total,3427,1652,1775,3345,82,46,2796.91,1.2,1.34925,52.7212,3515.0
1866,2011,NR12 8,NR12 8,Total,6715,3229,3486,6550,165,74,6830.46,1.0,1.43068,52.7194,6690.0
1867,2011,NR12 9,NR12 9,Total,5790,2810,2980,5714,76,62,3814.77,1.5,1.51192,52.7743,5566.0
1868,2011,NR13 3,NR13 3,Total,6802,3332,3470,6724,78,83,7620.47,0.9,1.54907,52.6068,6779.0
1869,2011,NR13 4,NR13 4,Total,6925,3335,3590,6888,37,88,3352.68,2.1,1.46395,52.6318,6973.0
1870,2011,NR13 5,NR13 5,Total,7558,3688,3870,7398,160,105,2372.41,3.2,1.4176,52.6325,7519.0
1871,2011,NR13 6,NR13 6,Total,5404,2611,2793,5320,84,77,5545.26,1.0,1.43964,52.6679,5440.0
1872,2011,NR14 6,NR14 6,Total,7305,3561,3744,7181,124,125,9246.3,0.8,1.49624,52.5344,7251.0
1873,2011,NR14 7,NR14 7,Total,8272,4063,4209,8196,76,134,5231.78,1.6,1.36932,52.5804,8201.0
1874,2011,NR14 8,NR14 8,Total,8170,3919,4251,8114,56,160,5321.71,1.5,1.27202,52.5796,8229.0
1875,2011,NR15 1,NR15 1,Total,6850,3310,3540,6751,99,121,6999.51,1.0,1.30836,52.5349,6844.0
1876,2011,NR15 2,NR15 2,Total,8956,4436,4520,8917,39,109,7412.72,1.2,1.22987,52.48,8962.0
1877,2011,NR16 1,NR16 1,Total,5532,2710,2822,5511,21,94,6756.43,0.8,1.15097,52.5057,5559.0
1878,2011,NR16 2,NR16 2,Total,6421,3160,3261,6275,146,93,9736.07,0.7,0.971416,52.4548,6492.0
1879,2011,NR17 1,NR17 1,Total,7062,3569,3493,6998,64,90,9483.06,0.7,0.979577,52.5146,7113.0
1880,2011,NR17 2,NR17 2,Total,8710,4246,4464,8607,103,100,1552.14,5.6,1.01868,52.5167,8688.0
1881,2011,NR18 0,NR18 0,Total,12223,5878,6345,12133,90,184,1880.0,6.5,1.12197,52.5779,12033.0
1882,2011,NR18 9,NR18 9,Total,5333,2648,2685,4638,695,106,7157.01,0.7,1.091,52.5612,5429.0
1883,2011,NR19 1,NR19 1,Total,11053,5356,5697,10976,77,88,1967.32,5.6,0.944154,52.6681,10962.0
1884,2011,NR19 2,NR19 2,Total,9306,4548,4758,9153,153,118,4963.27,1.9,0.911572,52.6836,9370.0
1885,2011,NR20 3,NR20 3,Total,7439,3599,3840,7244,195,110,6721.73,1.1,1.01518,52.6732,7122.0
1886,2011,NR20 4,NR20 4,Total,6941,3510,3431,6545,396,87,5694.11,1.2,0.956644,52.7207,7057.0
1887,2011,NR20 5,NR20 5,Total,4951,2454,2497,4887,64,80,10290.34,0.5,0.963877,52.7789,4970.0
1888,2011,NR21 0,NR21 0,Total,3250,1588,1662,3247,3,65,10115.82,0.3,0.925216,52.8597,3182.0
1889,2011,NR21 7,NR21 7,Total,3295,1641,1654,3295,0,42,6116.4,0.5,0.795769,52.8151,3463.0
1890,2011,NR21 8,NR21 8,Total,5164,2448,2716,5103,61,33,375.08,13.8,0.860712,52.8335,5132.0
1891,2011,NR21 9,NR21 9,Total,4106,2015,2091,4062,44,49,4896.79,0.8,0.820515,52.8517,4117.0
1892,2011,NR22 6,NR22 6,Total,819,395,424,811,8,13,1897.51,0.4,0.863667,52.8929,906.0
1893,2011,NR23 1,NR23 1,Total,3009,1441,1568,2965,44,41,6693.54,0.4,0.857809,52.9491,3067.0
1894,2011,NR24 2,NR24 2,Total,4462,2191,2271,4424,38,63,6233.42,0.7,1.04554,52.8578,4409.0
1895,2011,NR25 6,NR25 6,Total,5511,2568,2943,5148,363,84,3931.66,1.4,1.11263,52.9057,5471.0
1896,2011,NR25 7,NR25 7,Total,3367,1622,1745,3324,43,67,7887.72,0.4,1.05073,52.9362,3380.0
1897,2011,NR26 8,NR26 8,Total,8299,3877,4422,8090,209,106,1120.2,7.4,1.21143,52.9373,8416.0
1898,2011,NR27 0,NR27 0,Total,5250,2453,2797,5032,218,44,710.46,7.4,1.3184,52.9187,5606.0
1899,2011,NR27 9,NR27 9,Total,6483,3149,3334,6225,258,73,1636.71,4.0,1.28488,52.9297,6198.0
1900,2011,NR28 0,NR28 0,Total,9282,4477,4805,9138,144,86,4241.48,2.2,1.38032,52.829,9250.0
1901,2011,NR28 9,NR28 9,Total,8250,3932,4318,8105,145,72,5411.93,1.5,1.4136,52.8156,8092.0
1902,2011,NR29 3,NR29 3,Total,6914,3387,3527,6880,34,98,6242.0,1.1,1.66859,52.6628,6880.0
1903,2011,NR29 4,NR29 4,Total,8411,4060,4351,8240,171,108,3247.06,2.6,1.66665,52.7,8489.0
1904,2011,NR29 5,NR29 5,Total,4599,2292,2307,4509,90,40,4264.69,1.1,1.57347,52.708,4650.0
1905,2011,NR30 1,NR30 1,Total,4431,2187,2244,4325,106,11,651.47,6.8,1.7236,52.6119,4829.0
1906,2011,NR30 2,NR30 2,Total,5565,2926,2639,5433,132,30,87.15,63.9,1.73064,52.606,5668.0
1907,2011,NR30 3,NR30 3,Total,4419,2214,2205,4381,38,13,193.14,22.9,1.73173,52.5961,4470.0
1908,2011,NR30 4,NR30 4,Total,7210,3450,3760,7090,120,35,267.98,26.9,1.73139,52.6209,6683.0
1909,2011,NR30 5,NR30 5,Total,9076,4375,4701,9022,54,67,1072.66,8.5,1.72209,52.6506,9079.0
1910,2011,NR31 0,NR31 0,Total,7144,3586,3558,7115,29,40,316.54,22.6,1.71931,52.5996,7243.0
1911,2011,NR31 6,NR31 6,Total,8799,4275,4524,8641,158,79,214.49,41.0,1.72678,52.5726,9449.0
1912,2011,NR31 7,NR31 7,Total,11015,5367,5648,10943,72,70,262.98,41.9,1.7163,52.5725,10746.0
1913,2011,NR31 8,NR31 8,Total,13107,6395,6712,13046,61,88,939.94,13.9,1.70668,52.581,12455.0
1914,2011,NR31 9,NR31 9,Total,9849,4876,4973,9801,48,95,2826.55,3.5,1.68782,52.5661,10087.0
1915,2011,NR32 1,NR32 1,Total,3922,1932,1990,3877,45,35,125.74,31.2,1.75228,52.4796,3849.0
1916,2011,NR32 2,NR32 2,Total,9238,4516,4722,9227,11,48,225.78,40.9,1.74032,52.4796,8915.0
1917,2011,NR32 3,NR32 3,Total,8222,4006,4216,8110,112,77,359.49,22.9,1.71351,52.4838,8438.0
1918,2011,NR32 4,NR32 4,Total,13267,6419,6848,13118,149,123,535.58,24.8,1.73703,52.4926,13390.0
1919,2011,NR32 5,NR32 5,Total,4008,2193,1815,3518,490,50,3520.07,1.1,1.70977,52.5129,4045.0
1920,2011,NR33 0,NR33 0,Total,8315,4092,4223,8009,306,79,213.01,39.0,1.7391,52.4664,8550.0
1921,2011,NR33 7,NR33 7,Total,9176,4411,4765,9128,48,91,879.28,10.4,1.72263,52.4391,9186.0
1922,2011,NR33 8,NR33 8,Total,13572,6592,6980,13462,110,138,1608.65,8.4,1.70101,52.455,13213.0
1923,2011,NR33 9,NR33 9,Total,8404,4011,4393,8404,0,59,262.95,32.0,1.71749,52.4657,8643.0
1924,2011,NR34 0,NR34 0,Total,2235,1122,1113,2235,0,38,4377.64,0.5,1.57662,52.4836,2325.0
1925,2011,NR34 7,NR34 7,Total,7729,3758,3971,7729,0,97,7464.95,1.0,1.61804,52.4301,7725.0
1926,2011,NR34 8,NR34 8,Total,3002,1492,1510,2990,12,61,8175.13,0.4,1.55916,52.4024,3122.0
1927,2011,NR34 9,NR34 9,Total,9303,4439,4864,9175,128,81,786.65,11.8,1.56681,52.4539,9198.0
1928,2011,NR35 1,NR35 1,Total,5723,2767,2956,5586,137,59,3504.78,1.6,1.44343,52.4477,5797.0
1929,2011,NR35 2,NR35 2,Total,5171,2536,2635,5088,83,91,7470.32,0.7,1.42332,52.4744,5086.0
1930,2011,NW10 0,NW10 0,Total,11063,5326,5737,11063,0,70,184.56,59.9,-0.258848,51.5502,11214.0
1931,2011,NW10 1,NW10 1,Total,10006,5015,4991,9997,9,106,124.44,80.4,-0.243895,51.5509,9486.0
1932,2011,NW10 2,NW10 2,Total,9068,4540,4528,9008,60,78,105.37,86.1,-0.239354,51.5452,8581.0
1933,2011,NW10 3,NW10 3,Total,8483,4082,4401,8469,14,112,124.82,68.0,-0.232617,51.5373,9363.0
1934,2011,NW10 4,NW10 4,Total,10100,5103,4997,10053,47,79,67.02,150.7,-0.246585,51.5363,10301.0
1935,2011,NW10 5,NW10 5,Total,13687,6790,6897,13673,14,127,95.09,143.9,-0.232856,51.5329,13618.0
1936,2011,NW10 6,NW10 6,Total,2729,1348,1381,2717,12,16,215.84,12.6,-0.250386,51.529,2438.0
1937,2011,NW10 7,NW10 7,Total,3606,1793,1813,3588,18,36,244.52,14.7,-0.270962,51.5324,3642.0
1938,2011,NW10 8,NW10 8,Total,13236,6476,6760,13206,30,120,135.89,97.4,-0.256662,51.5398,12949.0
1939,2011,NW10 9,NW10 9,Total,10019,4887,5132,10010,9,96,83.14,120.5,-0.250312,51.5422,10367.0
1940,2011,NW11 0,NW11 0,Total,6691,3232,3459,6646,45,224,85.63,78.1,-0.201086,51.5817,5956.0
1941,2011,NW11 6,NW11 6,Total,6367,2958,3409,6354,13,128,161.84,39.3,-0.19023,51.5831,6180.0
1942,2011,NW11 7,NW11 7,Total,5285,2488,2797,5284,1,117,132.03,40.0,-0.19385,51.5766,5983.0
1943,2011,NW11 8,NW11 8,Total,6889,3395,3494,6750,139,146,109.42,63.0,-0.20058,51.5727,5776.0
1944,2011,NW11 9,NW11 9,Total,7452,3682,3770,7284,168,215,68.07,109.5,-0.206544,51.5784,8712.0
1945,2011,OL10 1,OL10 1,Total,3418,1741,1677,3347,71,21,118.29,28.9,-2.21544,53.592,3451.0
1946,2011,OL10 2,OL10 2,Total,7205,3511,3694,7116,89,111,604.46,11.9,-2.21715,53.5839,6925.0
1947,2011,OL10 3,OL10 3,Total,7947,3763,4184,7887,60,37,229.28,34.7,-2.23653,53.5897,8519.0
1948,2011,OL10 4,OL10 4,Total,9224,4481,4743,9207,17,86,745.36,12.4,-2.22302,53.5962,8991.0
1949,2011,OL11 1,OL11 1,Total,6705,3368,3337,6654,51,45,103.0,65.1,-2.15575,53.6076,6719.0
1950,2011,OL11 2,OL11 2,Total,10601,5034,5567,10563,38,66,577.3,18.4,-2.16134,53.5943,10616.0
1951,2011,OL11 3,OL11 3,Total,9313,4514,4799,9091,222,74,305.97,30.4,-2.17434,53.6014,9415.0
1952,2011,OL11 4,OL11 4,Total,7025,3446,3579,6896,129,67,313.28,22.4,-2.17663,53.6089,6788.0
1953,2011,OL11 5,OL11 5,Total,12168,6004,6164,12034,134,279,468.82,26.0,-2.19858,53.619,12055.0
1954,2011,OL12 0,OL12 0,Total,5407,2606,2801,5401,6,44,132.55,40.8,-2.15728,53.6264,6623.0
1955,2011,OL12 6,OL12 6,Total,12152,6108,6044,11997,155,133,588.18,20.7,-2.16739,53.625,10956.0
1956,2011,OL12 7,OL12 7,Total,9936,4758,5178,9930,6,169,670.19,14.8,-2.18824,53.6264,10628.0
1957,2011,OL12 8,OL12 8,Total,7500,3708,3792,7466,34,84,1813.93,4.1,-2.17399,53.6603,7323.0
1958,2011,OL12 9,OL12 9,Total,10672,5402,5270,10227,445,103,1362.81,7.8,-2.13636,53.6372,10695.0
1959,2011,OL13 0,OL13 0,Total,3834,1878,1956,3801,33,28,849.58,4.5,-2.21838,53.6935,3625.0
1960,2011,OL13 8,OL13 8,Total,4440,2199,2241,4385,55,67,995.61,4.5,-2.2043,53.708,4498.0
1961,2011,OL13 9,OL13 9,Total,6825,3356,3469,6799,26,43,514.34,13.3,-2.19271,53.701,7177.0
1962,2011,OL14 5,OL14 5,Total,4630,2238,2392,4603,27,37,116.12,39.9,-2.09367,53.7169,4817.0
1963,2011,OL14 6,OL14 6,Total,3619,1765,1854,3574,45,57,2293.76,1.6,-2.08805,53.7055,3699.0
1964,2011,OL14 7,OL14 7,Total,3073,1493,1580,3006,67,40,1663.2,1.8,-2.11127,53.708,3088.0
1965,2011,OL14 8,OL14 8,Total,4159,1970,2189,4094,65,62,1099.06,3.8,-2.11224,53.7274,3985.0
1966,2011,OL15 0,OL15 0,Total,3973,1876,2097,3833,140,36,1685.77,2.4,-2.10165,53.6355,3830.0
1967,2011,OL15 8,OL15 8,Total,5463,2700,2763,5443,20,34,157.54,34.7,-2.11047,53.6408,5801.0
1968,2011,OL15 9,OL15 9,Total,5025,2475,2550,4988,37,53,1053.72,4.8,-2.095,53.6522,5004.0
1969,2011,OL16 1,OL16 1,Total,445,259,186,387,58,1,44.44,10.0,-2.15612,53.6164,523.0
1970,2011,OL16 2,OL16 2,Total,10772,5428,5344,10723,49,50,318.94,33.8,-2.13965,53.6238,10164.0
1971,2011,OL16 3,OL16 3,Total,8462,4130,4332,8413,49,97,1833.7,4.6,-2.1094,53.6106,8675.0
1972,2011,OL16 4,OL16 4,Total,11684,5749,5935,11659,25,117,499.95,23.4,-2.12745,53.6034,11644.0
1973,2011,OL16 5,OL16 5,Total,6462,3163,3299,6407,55,45,129.49,49.9,-2.14169,53.6113,6241.0
1974,2011,OX10 0,OX10 0,Total,5564,2657,2907,5473,91,98,485.41,11.5,-1.13642,51.6038,5239.0
1975,2011,OX10 6,OX10 6,Total,6815,3593,3222,6099,716,136,4477.21,1.5,-1.09413,51.6073,6901.0
1976,2011,OX10 7,OX10 7,Total,5203,2573,2630,5199,4,71,2740.05,1.9,-1.15429,51.6479,5197.0
1977,2011,OX10 8,OX10 8,Total,3214,1571,1643,3149,65,49,1340.72,2.4,-1.12437,51.6014,3569.0
1978,2011,OX10 9,OX10 9,Total,5567,2697,2870,5452,115,131,2430.75,2.3,-1.14167,51.5837,5623.0
1979,2011,OX11 0,OX11 0,Total,5434,2663,2771,5405,29,112,2069.14,2.6,-1.28121,51.59,5325.0
1980,2011,OX11 7,OX11 7,Total,13108,6477,6631,12965,143,155,589.21,22.2,-1.2436,51.6121,12994.0
1981,2011,OX11 8,OX11 8,Total,8838,4347,4491,8838,0,86,187.24,47.2,-1.24166,51.6029,9069.0
1982,2011,OX11 9,OX11 9,Total,5722,2856,2866,5722,0,159,4928.03,1.2,-1.2261,51.5866,5892.0
1983,2011,OX12 0,OX12 0,Total,6155,3090,3065,6154,1,114,3092.3,2.0,-1.42424,51.6178,6274.0
1984,2011,OX12 7,OX12 7,Total,5301,2627,2674,5206,95,83,719.03,7.4,-1.41764,51.6,5393.0
1985,2011,OX12 8,OX12 8,Total,4855,2330,2525,4778,77,114,6577.62,0.7,-1.39803,51.5855,5003.0
1986,2011,OX12 9,OX12 9,Total,8953,4398,4555,8831,122,189,7150.77,1.3,-1.45027,51.5873,8559.0
1987,2011,OX13 5,OX13 5,Total,4783,2373,2410,4780,3,159,4960.23,1.0,-1.39236,51.6849,4856.0
1988,2011,OX13 6,OX13 6,Total,8676,4623,4053,7739,937,182,3589.64,2.4,-1.3147,51.6704,8641.0
1989,2011,OX14 1,OX14 1,Total,10071,4967,5104,9958,113,222,305.62,33.0,-1.28881,51.6767,10532.0
1990,2011,OX14 2,OX14 2,Total,8243,4387,3856,7601,642,204,1033.81,8.0,-1.26624,51.685,7996.0
1991,2011,OX14 3,OX14 3,Total,8304,4084,4220,8168,136,137,1115.26,7.4,-1.26514,51.6729,8453.0
1992,2011,OX14 4,OX14 4,Total,7883,3825,4058,7836,47,194,4903.0,1.6,-1.27569,51.6407,7525.0
1993,2011,OX14 5,OX14 5,Total,10009,4794,5215,9885,124,108,302.92,33.0,-1.28925,51.666,9776.0
1994,2011,OX15 0,OX15 0,Total,2695,1293,1402,2651,44,59,2471.95,1.1,-1.33273,51.9947,2679.0
1995,2011,OX15 4,OX15 4,Total,6784,3362,3422,6550,234,204,3604.2,1.9,-1.36085,52.0252,6746.0
1996,2011,OX15 5,OX15 5,Total,5331,2585,2746,5226,105,172,7995.66,0.7,-1.46869,52.0273,5227.0
1997,2011,OX15 6,OX15 6,Total,3289,1599,1690,3237,52,99,5515.84,0.6,-1.42109,52.0778,3371.0
1998,2011,OX16 0,OX16 0,Total,11337,5527,5810,11295,42,91,214.1,53.0,-1.35473,52.0624,11068.0
1999,2011,OX16 1,OX16 1,Total,10518,5147,5371,10518,0,99,287.35,36.6,-1.35328,52.0741,10594.0
2000,2011,OX16 2,OX16 2,Total,2713,1357,1356,2674,39,20,317.91,8.5,-1.33918,52.0682,2297.0
2001,2011,OX16 3,OX16 3,Total,5002,2494,2508,4955,47,38,72.04,69.4,-1.32538,52.0684,4731.0
2002,2011,OX16 4,OX16 4,Total,3625,1775,1850,3625,0,18,385.21,9.4,-1.32092,52.063,3868.0
2003,2011,OX16 5,OX16 5,Total,2612,1285,1327,2500,112,24,62.43,41.8,-1.33418,52.0602,2513.0
2004,2011,OX16 9,OX16 9,Total,11046,5233,5813,10758,288,146,766.8,14.4,-1.33895,52.0522,11638.0
2005,2011,OX17 1,OX17 1,Total,4308,2130,2178,4259,49,89,7434.49,0.6,-1.33131,52.1147,4499.0
2006,2011,OX17 2,OX17 2,Total,6553,3154,3399,6442,111,143,6081.52,1.1,-1.25382,52.0815,6617.0
2007,2011,OX17 3,OX17 3,Total,6114,2959,3155,6068,46,123,4881.93,1.3,-1.28939,52.02,6083.0
2008,2011,OX18 1,OX18 1,Total,6826,3342,3484,6759,67,95,144.62,47.2,-1.59251,51.7692,6792.0
2009,2011,OX18 2,OX18 2,Total,5555,2755,2800,5522,33,113,6365.48,0.9,-1.55338,51.7268,5523.0
2010,2011,OX18 3,OX18 3,Total,9881,5310,4571,8694,1187,149,1552.05,6.4,-1.59171,51.7599,9930.0
2011,2011,OX18 4,OX18 4,Total,3039,1484,1555,2901,138,94,7850.61,0.4,-1.63834,51.801,3102.0
2012,2011,OX20 1,OX20 1,Total,4734,2212,2522,4680,54,86,4515.12,1.0,-1.35712,51.8547,4821.0
2013,2011,OX25 1,OX25 1,Total,2425,1643,782,1547,878,20,2419.33,1.0,-1.10225,51.8621,2390.0
2014,2011,OX25 2,OX25 2,Total,2507,1223,1284,2409,98,48,1383.21,1.8,-1.14183,51.8739,2785.0
2015,2011,OX25 3,OX25 3,Total,523,250,273,521,2,16,1005.58,0.5,-1.21702,51.8682,577.0
2016,2011,OX25 4,OX25 4,Total,1278,639,639,1270,8,28,1185.66,1.1,-1.26029,51.9153,1473.0
2017,2011,OX25 5,OX25 5,Total,1787,884,903,1787,0,18,1372.8,1.3,-1.25999,51.926,1850.0
2018,2011,OX25 6,OX25 6,Total,1099,533,566,1098,1,40,2390.5,0.5,-1.2931,51.9523,1010.0
2019,2011,OX26 1,OX26 1,Total,850,459,391,769,81,17,1319.45,0.6,-1.17698,51.8933,791.0
2020,2011,OX26 2,OX26 2,Total,9155,4485,4670,9155,0,82,204.14,44.8,-1.16396,51.903,9247.0
2021,2011,OX26 3,OX26 3,Total,7014,3444,3570,7014,0,68,123.45,56.8,-1.15331,51.9101,7020.0
2022,2011,OX26 4,OX26 4,Total,5846,2922,2924,5833,13,66,188.29,31.0,-1.13993,51.9053,5838.0
2023,2011,OX26 5,OX26 5,Total,1204,583,621,1204,0,16,1049.7,1.1,-1.11878,51.9019,1195.0
2024,2011,OX26 6,OX26 6,Total,9425,4756,4669,9076,349,71,857.15,11.0,-1.14653,51.8965,9069.0
2025,2011,OX27 0,OX27 0,Total,969,480,489,969,0,26,1135.86,0.9,-1.06152,51.9039,1230.0
2026,2011,OX27 7,OX27 7,Total,2117,1008,1109,2091,26,34,3038.74,0.7,-1.21149,51.9511,2182.0
2027,2011,OX27 8,OX27 8,Total,2883,1411,1472,2806,77,59,2918.52,1.0,-1.14551,51.9324,2881.0
2028,2011,OX27 9,OX27 9,Total,548,271,277,548,0,19,1731.6,0.3,-1.10428,51.9297,554.0
2029,2011,OX28 1,OX28 1,Total,7888,3815,4073,7775,113,124,181.09,43.6,-1.47478,51.7919,7836.0
2030,2011,OX28 2,OX28 2,Total,854,398,456,824,30,18,33.73,25.3,-1.47358,51.7893,661.0
2031,2011,OX28 3,OX28 3,Total,3087,1494,1593,3087,0,63,133.69,23.1,-1.47316,51.7846,3311.0
2032,2011,OX28 4,OX28 4,Total,1601,751,850,1594,7,20,51.71,31.0,-1.4871,51.7792,2142.0
2033,2011,OX28 5,OX28 5,Total,9222,4581,4641,9222,0,144,349.86,26.4,-1.50183,51.7826,8972.0
2034,2011,OX28 6,OX28 6,Total,4870,2301,2569,4801,69,59,172.24,28.3,-1.48915,51.7868,4655.0
2035,2011,OX29 0,OX29 0,Total,1409,684,725,1404,5,19,789.28,1.8,-1.53166,51.7909,1488.0
2036,2011,OX29 4,OX29 4,Total,5398,2604,2794,5352,46,96,2386.9,2.3,-1.37966,51.7829,5392.0
2037,2011,OX29 5,OX29 5,Total,1337,661,676,1337,0,54,2219.44,0.6,-1.40151,51.7448,1324.0
2038,2011,OX29 6,OX29 6,Total,2454,1201,1253,2437,17,68,3555.55,0.7,-1.4433,51.8054,2436.0
2039,2011,OX29 7,OX29 7,Total,3607,1813,1794,3525,82,73,3140.4,1.1,-1.48175,51.7625,3594.0
2040,2011,OX29 8,OX29 8,Total,6485,3177,3308,6412,73,144,2434.36,2.7,-1.40862,51.8293,6501.0
2041,2011,OX29 9,OX29 9,Total,2370,1151,1219,2312,58,65,3114.87,0.8,-1.51647,51.8165,2333.0
2042,2011,OX33 1,OX33 1,Total,7623,3743,3880,7500,123,191,5489.38,1.4,-1.14366,51.7567,7555.0
2043,2011,OX39 4,OX39 4,Total,6881,3351,3530,6851,30,120,3292.61,2.1,-0.917174,51.7037,6901.0
2044,2011,OX44 7,OX44 7,Total,5449,2688,2761,5447,2,113,5444.36,1.0,-1.11283,51.6942,5261.0
2045,2011,OX44 9,OX44 9,Total,2858,1402,1456,2832,26,52,3399.3,0.8,-1.17235,51.712,2835.0
2046,2011,OX49 5,OX49 5,Total,4324,2055,2269,4279,45,122,6508.41,0.7,-1.00184,51.6492,4243.0
2047,2011,PE10 0,PE10 0,Total,10175,5026,5149,10081,94,210,15836.27,0.6,-0.377244,52.7784,10569.0
2048,2011,PE10 9,PE10 9,Total,11731,5608,6123,11525,206,219,1277.49,9.2,-0.377369,52.77,11467.0
2049,2011,PE11 1,PE11 1,Total,8392,4078,4314,8330,62,91,240.21,34.9,-0.157827,52.7892,9083.0
2050,2011,PE11 2,PE11 2,Total,12978,6290,6688,12819,159,133,699.96,18.5,-0.147974,52.7864,12556.0
2051,2011,PE11 3,PE11 3,Total,13420,6574,6846,13307,113,150,13232.17,1.0,-0.17868,52.7884,12979.0
2052,2011,PE11 4,PE11 4,Total,8440,4126,4314,8344,96,83,9117.17,0.9,-0.178599,52.8715,8448.0
2053,2011,PE12 0,PE12 0,Total,6334,3150,3184,6332,2,70,9897.58,0.6,0.00752881,52.7398,6450.0
2054,2011,PE12 6,PE12 6,Total,9409,4655,4754,9384,25,115,10592.05,0.9,-0.0826901,52.791,9396.0
2055,2011,PE12 7,PE12 7,Total,8061,3888,4173,8001,60,67,827.0,9.7,0.0138726,52.8044,7812.0
2056,2011,PE12 8,PE12 8,Total,4577,2236,2341,4439,138,58,11696.89,0.4,0.0309901,52.8087,4890.0
2057,2011,PE12 9,PE12 9,Total,11401,5540,5861,11219,182,76,11078.55,1.0,0.123456,52.7877,11286.0
2058,2011,PE13 1,PE13 1,Total,2998,1500,1498,2969,29,23,204.79,14.6,0.155489,52.6658,3053.0
2059,2011,PE13 2,PE13 2,Total,8459,4088,4371,8271,188,63,286.55,29.5,0.164716,52.6594,8829.0
2060,2011,PE13 3,PE13 3,Total,11161,5488,5673,11003,158,66,293.06,38.1,0.169112,52.6719,11080.0
2061,2011,PE13 4,PE13 4,Total,6569,3234,3335,6563,6,78,7848.98,0.8,0.0732345,52.6491,6522.0
2062,2011,PE13 5,PE13 5,Total,5706,2815,2891,5691,15,51,5408.35,1.1,0.125529,52.7013,5699.0
2063,2011,PE14 0,PE14 0,Total,5481,2653,2828,5397,84,45,6447.72,0.9,0.158588,52.6352,5081.0
2064,2011,PE14 7,PE14 7,Total,5883,2962,2921,5822,61,64,6586.88,0.9,0.216877,52.7037,6103.0
2065,2011,PE14 8,PE14 8,Total,5314,2632,2682,5259,55,46,4807.93,1.1,0.231472,52.635,5487.0
2066,2011,PE14 9,PE14 9,Total,4125,2002,2123,4107,18,46,7638.73,0.5,0.217061,52.57,4188.0
2067,2011,PE15 0,PE15 0,Total,9169,4706,4463,8715,454,82,16750.44,0.5,0.0830163,52.5125,8988.0
2068,2011,PE15 8,PE15 8,Total,10515,5163,5352,10445,70,80,567.98,18.5,0.0856746,52.5562,11016.0
2069,2011,PE15 9,PE15 9,Total,10231,4883,5348,10046,185,81,484.6,21.1,0.0888689,52.5456,9865.0
2070,2011,PE16 6,PE16 6,Total,10453,5163,5290,10414,39,100,6117.96,1.7,0.0493352,52.4548,10435.0
2071,2011,PE19 1,PE19 1,Total,6777,3327,3450,6739,38,79,339.32,20.0,-0.258828,52.2338,6904.0
2072,2011,PE19 2,PE19 2,Total,9972,5034,4938,9904,68,77,286.04,34.9,-0.264463,52.2228,9652.0
2073,2011,PE19 5,PE19 5,Total,6845,3371,3474,6801,44,142,10553.97,0.6,-0.267234,52.2789,6646.0
2074,2011,PE19 6,PE19 6,Total,7855,3887,3968,7791,64,117,7823.43,1.0,-0.235,52.237,8068.0
2075,2011,PE19 7,PE19 7,Total,5309,2660,2649,5266,43,102,232.41,22.8,-0.274027,52.237,5070.0
2076,2011,PE19 8,PE19 8,Total,7210,3606,3604,7148,62,61,230.97,31.2,-0.281573,52.2273,7453.0
2077,2011,PE20 1,PE20 1,Total,6670,3208,3462,6595,75,75,5306.38,1.3,-0.0605321,52.9365,6421.0
2078,2011,PE20 2,PE20 2,Total,2942,1463,1479,2942,0,29,4478.94,0.7,-0.085539,52.8996,2907.0
2079,2011,PE20 3,PE20 3,Total,4374,2165,2209,4374,0,52,8368.41,0.5,-0.155753,52.9524,4795.0
2080,2011,PE21 0,PE21 0,Total,9653,4579,5074,9571,82,92,1413.87,6.8,-8.51e-05,52.9715,9738.0
2081,2011,PE21 6,PE21 6,Total,3135,1559,1576,3074,61,28,117.82,26.6,-0.0215419,52.9773,3131.0
2082,2011,PE21 7,PE21 7,Total,8925,4338,4587,8814,111,101,1976.28,4.5,-0.0368841,52.9633,8803.0
2083,2011,PE21 8,PE21 8,Total,12216,5959,6257,12104,112,69,350.37,34.9,-0.0341572,52.9772,12373.0
2084,2011,PE21 9,PE21 9,Total,8858,4200,4658,8751,107,115,972.24,9.1,-0.018191,52.9855,8823.0
2085,2011,PE22 0,PE22 0,Total,6084,3212,2872,5753,331,80,8132.75,0.7,0.0475948,53.0004,5989.0
2086,2011,PE22 7,PE22 7,Total,3394,1690,1704,3394,0,55,12577.29,0.3,-0.0686592,53.0798,3394.0
2087,2011,PE22 8,PE22 8,Total,4022,1989,2033,4000,22,41,9722.72,0.4,0.0899046,53.0863,3985.0
2088,2011,PE22 9,PE22 9,Total,3419,1668,1751,3397,22,43,5157.78,0.7,0.100775,53.0387,3455.0
2089,2011,PE23 4,PE23 4,Total,2586,1261,1325,2540,46,39,8648.39,0.3,0.0463548,53.1811,2712.0
2090,2011,PE23 5,PE23 5,Total,5921,2869,3052,5758,163,63,7251.44,0.8,0.117146,53.1675,5969.0
2091,2011,PE24 4,PE24 4,Total,4133,2017,2116,4092,41,39,8770.18,0.5,0.243208,53.1217,4042.0
2092,2011,PE24 5,PE24 5,Total,7697,3762,3935,7632,65,54,6153.69,1.3,0.287619,53.1982,7637.0
2093,2011,PE25 1,PE25 1,Total,7225,3503,3722,6719,506,50,1200.11,6.0,0.337411,53.1682,7823.0
2094,2011,PE25 2,PE25 2,Total,8823,4254,4569,8620,203,36,522.66,16.9,0.330242,53.149,8106.0
2095,2011,PE25 3,PE25 3,Total,5590,2639,2951,5329,261,73,427.37,13.1,0.335796,53.1385,5802.0
2096,2011,PE26 1,PE26 1,Total,5640,2792,2848,5618,22,64,702.77,8.0,-0.110207,52.4484,5915.0
2097,2011,PE26 2,PE26 2,Total,6305,3153,3152,6208,97,99,9575.77,0.7,-0.120482,52.4575,5851.0
2098,2011,PE27 3,PE27 3,Total,7648,3774,3874,7648,0,126,417.22,18.3,-0.0780789,52.3373,7892.0
2099,2011,PE27 4,PE27 4,Total,2517,1263,1254,2515,2,47,1179.5,2.1,-0.0477855,52.3299,2508.0
2100,2011,PE27 5,PE27 5,Total,5225,2611,2614,5191,34,56,649.72,8.0,-0.0762175,52.3251,5184.0
2101,2011,PE27 6,PE27 6,Total,4625,2278,2347,4619,6,75,226.3,20.4,-0.0875594,52.3343,4346.0
2102,2011,PE28 0,PE28 0,Total,6509,3792,2717,5308,1201,141,9056.99,0.7,-0.355659,52.3219,6749.0
2103,2011,PE28 2,PE28 2,Total,9050,4481,4569,9050,0,172,9685.36,0.9,-0.120862,52.375,9291.0
2104,2011,PE28 3,PE28 3,Total,9544,4793,4751,9470,74,166,7549.57,1.3,-0.0240993,52.3696,9554.0
2105,2011,PE28 4,PE28 4,Total,8571,4273,4298,8177,394,183,5268.86,1.6,-0.231139,52.3477,8551.0
2106,2011,PE28 5,PE28 5,Total,7553,3780,3773,7453,100,109,14335.56,0.5,-0.294943,52.4151,7369.0
2107,2011,PE28 9,PE28 9,Total,6347,3059,3288,6342,5,130,2954.06,2.1,-0.103102,52.3072,6455.0
2108,2011,PE29 1,PE29 1,Total,12110,5937,6173,11951,159,87,391.18,31.0,-0.170976,52.3398,11695.0
2109,2011,PE29 2,PE29 2,Total,6711,3275,3436,6711,0,114,1984.13,3.4,-0.171336,52.3189,6708.0
2110,2011,PE29 3,PE29 3,Total,1838,955,883,1816,22,14,84.17,21.8,-0.184211,52.3316,2066.0
2111,2011,PE29 6,PE29 6,Total,5529,2737,2792,5525,4,100,267.93,20.6,-0.196502,52.3398,5572.0
2112,2011,PE29 7,PE29 7,Total,3594,1771,1823,3528,66,22,169.68,21.2,-0.182646,52.3426,3548.0
2113,2011,PE30 1,PE30 1,Total,1912,939,973,1857,55,9,69.02,27.7,0.398032,52.7554,2023.0
2114,2011,PE30 2,PE30 2,Total,7060,3469,3591,6988,72,46,485.37,14.5,0.406057,52.7628,7176.0
2115,2011,PE30 3,PE30 3,Total,14373,6973,7400,14179,194,238,3111.61,4.6,0.433679,52.7749,14416.0
2116,2011,PE30 4,PE30 4,Total,12918,6261,6657,12800,118,98,472.83,27.3,0.424784,52.7527,12877.0
2117,2011,PE30 5,PE30 5,Total,7726,3865,3861,7631,95,49,290.83,26.6,0.400379,52.7476,7638.0
2118,2011,PE31 6,PE31 6,Total,7919,3753,4166,7884,35,97,14072.58,0.6,0.535315,52.8345,7963.0
2119,2011,PE31 7,PE31 7,Total,7320,3430,3890,7176,144,75,3712.12,2.0,0.491952,52.8914,7307.0
2120,2011,PE31 8,PE31 8,Total,4764,2299,2465,4710,54,96,16513.87,0.3,0.664022,52.9035,4641.0
2121,2011,PE32 1,PE32 1,Total,8945,4329,4616,8916,29,134,15812.45,0.6,0.528812,52.7315,8928.0
2122,2011,PE32 2,PE32 2,Total,6349,3150,3199,6296,53,109,17384.25,0.4,0.730424,52.7264,6394.0
2123,2011,PE33 0,PE33 0,Total,7744,3761,3983,7657,87,96,7464.8,1.0,0.416735,52.6892,7727.0
2124,2011,PE33 9,PE33 9,Total,8201,4342,3859,7397,804,140,13849.65,0.6,0.503392,52.6172,8078.0
2125,2011,PE34 3,PE34 3,Total,5421,2695,2726,5418,3,57,6630.52,0.8,0.372078,52.6989,5439.0
2126,2011,PE34 4,PE34 4,Total,8963,4384,4579,8926,37,91,9571.51,0.9,0.318111,52.7499,8536.0
2127,2011,PE36 5,PE36 5,Total,3717,1722,1995,3624,93,44,3680.79,1.0,0.5026,52.9302,3850.0
2128,2011,PE36 6,PE36 6,Total,2812,1344,1468,2713,99,74,3472.91,0.8,0.511138,52.9478,2512.0
2129,2011,PE37 7,PE37 7,Total,6803,3167,3636,6546,257,52,2946.43,2.3,0.678374,52.6498,6654.0
2130,2011,PE37 8,PE37 8,Total,3421,1661,1760,3409,12,34,7341.48,0.5,0.715016,52.6344,3564.0
2131,2011,PE38 0,PE38 0,Total,4815,2437,2378,4815,0,68,11715.12,0.4,0.369993,52.5627,4923.0
2132,2011,PE38 9,PE38 9,Total,9994,4752,5242,9871,123,95,520.36,19.2,0.379449,52.6068,9933.0
2133,2011,PL10 1,PL10 1,Total,3656,1771,1885,3656,0,43,1796.0,2.0,-4.21236,50.3476,3453.0
2134,2011,PL11 2,PL11 2,Total,7894,3799,4095,7872,22,75,473.67,16.7,-4.20732,50.3761,7960.0
2135,2011,PL11 3,PL11 3,Total,2465,1181,1284,2465,0,26,4013.9,0.6,-4.31998,50.3691,2535.0
2136,2011,PL12 4,PL12 4,Total,10571,5106,5465,10542,29,134,1645.06,6.4,-4.22941,50.408,10702.0
2137,2011,PL12 5,PL12 5,Total,2453,1230,1223,2453,0,33,3482.16,0.7,-4.30923,50.415,2608.0
2138,2011,PL12 6,PL12 6,Total,8763,4307,4456,8763,0,117,5553.22,1.6,-4.23453,50.4306,8576.0
2139,2011,PL13 1,PL13 1,Total,4225,2048,2177,4169,56,41,2465.15,1.7,-4.44669,50.3638,4146.0
2140,2011,PL13 2,PL13 2,Total,5213,2540,2673,5213,0,57,6223.85,0.8,-4.49591,50.3547,5258.0
2141,2011,PL14 3,PL14 3,Total,8347,4001,4346,8347,0,107,7337.67,1.1,-4.44327,50.4543,8258.0
2142,2011,PL14 4,PL14 4,Total,5527,2708,2819,5525,2,56,6602.41,0.8,-4.48474,50.44,5348.0
2143,2011,PL14 5,PL14 5,Total,5600,2744,2856,5600,0,70,4098.03,1.4,-4.44049,50.4987,5447.0
2144,2011,PL14 6,PL14 6,Total,3492,1665,1827,3492,0,44,8364.74,0.4,-4.50258,50.4674,3814.0
2145,2011,PL15 7,PL15 7,Total,6337,3027,3310,6111,226,95,13595.75,0.5,-4.41876,50.6108,6331.0
2146,2011,PL15 8,PL15 8,Total,7078,3508,3570,6956,122,84,13411.46,0.5,-4.41145,50.6515,7211.0
2147,2011,PL15 9,PL15 9,Total,6492,3148,3344,6337,155,79,9950.46,0.7,-4.35101,50.6327,6540.0
2148,2011,PL16 0,PL16 0,Total,1753,878,875,1753,0,34,4470.85,0.4,-4.27499,50.645,1889.0
2149,2011,PL17 7,PL17 7,Total,5788,2903,2885,5788,0,61,3809.92,1.5,-4.3185,50.5073,5458.0
2150,2011,PL17 8,PL17 8,Total,4234,2102,2132,4154,80,57,4524.16,0.9,-4.29303,50.5236,4615.0
2151,2011,PL18 9,PL18 9,Total,4810,2331,2479,4810,0,104,1474.83,3.3,-4.22382,50.5156,4896.0
2152,2011,PL19 0,PL19 0,Total,3003,1481,1522,2746,257,67,4180.93,0.7,-4.16121,50.5661,3671.0
2153,2011,PL19 8,PL19 8,Total,6185,2916,3269,6022,163,112,5776.57,1.1,-4.17036,50.5493,5592.0
2154,2011,PL19 9,PL19 9,Total,7235,3394,3841,7116,119,154,8553.24,0.8,-4.12911,50.5526,7180.0
2155,2011,PL20 6,PL20 6,Total,5334,2771,2563,4703,631,121,28251.39,0.2,-4.05226,50.5146,5410.0
2156,2011,PL20 7,PL20 7,Total,6747,3261,3486,6664,83,103,4247.89,1.6,-4.14466,50.4938,6674.0
2157,2011,PL21 0,PL21 0,Total,9481,4560,4921,9342,139,196,4899.77,1.9,-3.89718,50.38,9835.0
2158,2011,PL21 9,PL21 9,Total,7908,3840,4068,7864,44,159,6770.78,1.2,-3.94276,50.3912,7906.0
2159,2011,PL22 0,PL22 0,Total,3695,1752,1943,3568,127,37,6827.87,0.5,-4.65343,50.4037,3642.0
2160,2011,PL23 1,PL23 1,Total,3519,1672,1847,3430,89,68,3135.18,1.1,-4.63647,50.3371,3410.0
2161,2011,PL24 2,PL24 2,Total,10156,4876,5280,9854,302,73,1663.03,6.1,-4.71298,50.3546,10447.0
2162,2011,PL25 3,PL25 3,Total,10992,5313,5679,10869,123,111,769.44,14.3,-4.76236,50.3435,11226.0
2163,2011,PL25 4,PL25 4,Total,8871,4219,4652,8487,384,79,295.51,30.0,-4.78404,50.3399,8338.0
2164,2011,PL25 5,PL25 5,Total,5688,2785,2903,5537,151,59,1163.97,4.9,-4.79833,50.3401,5974.0
2165,2011,PL26 6,PL26 6,Total,5142,2434,2708,4961,181,61,5804.04,0.9,-4.79011,50.2805,4842.0
2166,2011,PL26 7,PL26 7,Total,9609,4703,4906,9570,39,82,5118.79,1.9,-4.85506,50.3446,9802.0
2167,2011,PL26 8,PL26 8,Total,11922,5939,5983,11845,77,79,6711.26,1.8,-4.82038,50.3906,11947.0
2168,2011,PL27 6,PL27 6,Total,5364,2540,2824,5209,155,96,5444.17,1.0,-4.86611,50.5395,5447.0
2169,2011,PL27 7,PL27 7,Total,6863,3226,3637,6640,223,82,7982.53,0.9,-4.88142,50.5072,6634.0
2170,2011,PL28 8,PL28 8,Total,4434,2114,2320,4324,110,39,2954.75,1.5,-4.96709,50.5325,4515.0
2171,2011,PL29 3,PL29 3,Total,1029,505,524,972,57,10,1529.6,0.7,-4.82699,50.5827,1060.0
2172,2011,PL30 3,PL30 3,Total,3597,1754,1843,3491,106,56,8831.51,0.4,-4.75298,50.5496,3442.0
2173,2011,PL30 4,PL30 4,Total,2576,1247,1329,2557,19,35,12977.92,0.2,-4.67334,50.5099,2736.0
2174,2011,PL30 5,PL30 5,Total,4384,2158,2226,4308,76,34,10233.84,0.4,-4.75833,50.4383,4124.0
2175,2011,PL31 1,PL31 1,Total,8199,3942,4257,8037,162,95,752.75,10.9,-4.72306,50.4659,8178.0
2176,2011,PL31 2,PL31 2,Total,6537,3200,3337,6438,99,62,587.7,11.1,-4.72239,50.4716,6397.0
2177,2011,PL32 9,PL32 9,Total,4326,2091,2235,4257,69,41,9111.28,0.5,-4.66361,50.6322,4148.0
2178,2011,PL33 9,PL33 9,Total,1647,803,844,1647,0,16,272.02,6.1,-4.73147,50.6224,1911.0
2179,2011,PL34 0,PL34 0,Total,1782,859,923,1712,70,11,1972.99,0.9,-4.74368,50.66,1755.0
2180,2011,PL35 0,PL35 0,Total,940,455,485,935,5,9,2103.32,0.4,-4.68486,50.6844,939.0
2181,2011,PO10 7,PO10 7,Total,9492,4522,4970,9278,214,148,482.2,19.7,-0.940321,50.8528,9496.0
2182,2011,PO10 8,PO10 8,Total,8868,4375,4493,8366,502,126,1862.58,4.8,-0.918985,50.8506,8772.0
2183,2011,PO11 0,PO11 0,Total,7863,3805,4058,7602,261,99,1192.63,6.6,-0.985794,50.7984,7684.0
2184,2011,PO11 9,PO11 9,Total,9516,4585,4931,9330,186,61,396.84,24.0,-0.96858,50.7857,9695.0
2185,2011,PO12 1,PO12 1,Total,8612,4328,4284,8567,45,42,149.86,57.5,-1.12962,50.7956,8571.0
2186,2011,PO12 2,PO12 2,Total,9715,4713,5002,9319,396,178,438.32,22.2,-1.14824,50.7884,10123.0
2187,2011,PO12 3,PO12 3,Total,12097,6004,6093,11928,169,100,315.11,38.4,-1.1493,50.7998,12429.0
2188,2011,PO12 4,PO12 4,Total,17422,8736,8686,17355,67,144,410.77,42.4,-1.14189,50.8076,16646.0
2189,2011,PO13 0,PO13 0,Total,16151,7903,8248,16148,3,80,527.97,30.6,-1.1719,50.8225,16223.0
2190,2011,PO13 8,PO13 8,Total,7299,3555,3744,7299,0,77,317.55,23.0,-1.17964,50.8024,7407.0
2191,2011,PO13 9,PO13 9,Total,11326,5497,5829,11150,176,125,372.51,30.4,-1.18689,50.8051,11341.0
2192,2011,PO14 1,PO14 1,Total,7734,3751,3983,7599,135,56,333.12,23.2,-1.19631,50.8448,7779.0
2193,2011,PO14 2,PO14 2,Total,7808,3731,4077,7711,97,93,659.27,11.8,-1.21203,50.8249,7790.0
2194,2011,PO14 3,PO14 3,Total,8589,4106,4483,8485,104,182,444.26,19.3,-1.2204,50.8323,8747.0
2195,2011,PO14 4,PO14 4,Total,8046,3983,4063,8001,45,141,976.74,8.2,-1.24507,50.851,8056.0
2196,2011,PO15 5,PO15 5,Total,7275,3547,3728,7205,70,89,400.13,18.2,-1.21868,50.8563,7053.0
2197,2011,PO15 6,PO15 6,Total,8357,4053,4304,8308,49,84,607.61,13.8,-1.20967,50.8621,8416.0
2198,2011,PO15 7,PO15 7,Total,7252,3676,3576,7252,0,87,746.02,9.7,-1.23589,50.8728,7057.0
2199,2011,PO16 0,PO16 0,Total,5642,2790,2852,5591,51,44,178.37,31.6,-1.18137,50.8486,5486.0
2200,2011,PO16 7,PO16 7,Total,7726,3743,3983,7446,280,112,223.98,34.5,-1.18518,50.857,8043.0
2201,2011,PO16 8,PO16 8,Total,10727,5314,5413,10626,101,126,611.14,17.6,-1.14734,50.852,10482.0
2202,2011,PO16 9,PO16 9,Total,8561,4170,4391,8561,0,84,268.3,31.9,-1.13277,50.8432,8601.0
2203,2011,PO17 5,PO17 5,Total,4654,2333,2321,4519,135,63,2116.96,2.2,-1.19365,50.8904,4553.0
2204,2011,PO17 6,PO17 6,Total,1873,924,949,1685,188,43,2275.03,0.8,-1.14031,50.8833,2082.0
2205,2011,PO18 0,PO18 0,Total,4600,2153,2447,4460,140,97,10789.72,0.4,-0.747748,50.8729,4537.0
2206,2011,PO18 8,PO18 8,Total,6691,3255,3436,6544,147,168,2859.13,2.3,-0.85015,50.8399,6888.0
2207,2011,PO18 9,PO18 9,Total,1726,853,873,1702,24,57,5325.93,0.3,-0.849275,50.8882,1800.0
2208,2011,PO19 1,PO19 1,Total,1639,740,899,1359,280,44,81.87,20.0,-0.779042,50.8361,1895.0
2209,2011,PO19 3,PO19 3,Total,6238,2916,3322,6156,82,94,458.42,13.6,-0.794999,50.8398,6362.0
2210,2011,PO19 5,PO19 5,Total,2378,1129,1249,2378,0,58,137.7,17.3,-0.78182,50.8499,2785.0
2211,2011,PO19 6,PO19 6,Total,6918,3231,3687,6550,368,80,227.96,30.3,-0.772614,50.8455,6238.0
2212,2011,PO19 7,PO19 7,Total,7595,3651,3944,7565,30,82,155.97,48.7,-0.76633,50.8361,7728.0
2213,2011,PO19 8,PO19 8,Total,5477,2569,2908,5398,79,74,613.69,8.9,-0.77946,50.8285,5195.0
2214,2011,PO20 0,PO20 0,Total,8566,4011,4555,8382,184,49,348.26,24.6,-0.785458,50.7324,8771.0
2215,2011,PO20 1,PO20 1,Total,2458,1187,1271,2445,13,46,1482.75,1.7,-0.762226,50.8152,2688.0
2216,2011,PO20 2,PO20 2,Total,3676,1755,1921,3585,91,53,1864.53,2.0,-0.726752,50.8434,3438.0
2217,2011,PO20 3,PO20 3,Total,4321,2090,2231,4264,57,74,710.08,6.1,-0.678282,50.8386,4504.0
2218,2011,PO20 7,PO20 7,Total,3571,1769,1802,3527,44,98,3515.73,1.0,-0.813968,50.7963,3923.0
2219,2011,PO20 8,PO20 8,Total,7358,3449,3909,7180,178,111,1398.51,5.3,-0.862988,50.7735,7181.0
2220,2011,PO20 9,PO20 9,Total,2171,1039,1132,2079,92,28,618.22,3.5,-0.79489,50.7349,1966.0
2221,2011,PO21 1,PO21 1,Total,6178,2994,3184,5228,950,37,118.4,52.2,-0.6734,50.7847,5957.0
2222,2011,PO21 2,PO21 2,Total,9933,4800,5133,9139,794,72,149.98,66.2,-0.683111,50.7854,10004.0
2223,2011,PO21 3,PO21 3,Total,8015,3827,4188,7976,39,63,966.38,8.3,-0.712802,50.7835,7900.0
2224,2011,PO21 4,PO21 4,Total,7269,3371,3898,7241,28,72,343.43,21.2,-0.721615,50.7764,7273.0
2225,2011,PO21 5,PO21 5,Total,8907,4262,4645,8858,49,57,393.69,22.6,-0.694126,50.7949,8410.0
2226,2011,PO22 0,PO22 0,Total,3808,1842,1966,3748,60,63,598.2,6.4,-0.641091,50.8284,3691.0
2227,2011,PO22 6,PO22 6,Total,5855,2782,3073,5832,23,63,347.93,16.8,-0.624456,50.7946,5860.0
2228,2011,PO22 7,PO22 7,Total,5604,2577,3027,5535,69,85,205.26,27.3,-0.642173,50.7897,5618.0
2229,2011,PO22 8,PO22 8,Total,5714,2716,2998,5641,73,52,402.98,14.2,-0.653828,50.7945,5950.0
2230,2011,PO22 9,PO22 9,Total,7369,3559,3810,7357,12,50,855.82,8.6,-0.677451,50.7994,7756.0
2231,2011,PO30 1,PO30 1,Total,7158,3431,3727,7049,109,89,591.51,12.1,-1.2981,50.6963,7042.0
2232,2011,PO30 2,PO30 2,Total,5310,2567,2743,5158,152,36,416.92,12.7,-1.27956,50.7014,5604.0
2233,2011,PO30 3,PO30 3,Total,2331,1126,1205,2285,46,41,6755.73,0.3,-1.30137,50.6629,2208.0
2234,2011,PO30 4,PO30 4,Total,3094,1483,1611,3070,24,43,5715.62,0.5,-1.39863,50.6724,2820.0
2235,2011,PO30 5,PO30 5,Total,12416,6913,5503,10717,1699,110,1349.82,9.2,-1.30584,50.7039,12498.0
2236,2011,PO31 7,PO31 7,Total,8632,4208,4424,8522,110,94,172.65,50.0,-1.30025,50.7548,8712.0
2237,2011,PO31 8,PO31 8,Total,5766,2772,2994,5707,59,89,1072.44,5.4,-1.31505,50.7489,5823.0
2238,2011,PO32 6,PO32 6,Total,8101,3902,4199,7976,125,60,1131.56,7.2,-1.28155,50.7498,8017.0
2239,2011,PO33 1,PO33 1,Total,8636,4169,4467,8475,161,66,733.7,11.8,-1.13896,50.7153,8737.0
2240,2011,PO33 2,PO33 2,Total,7663,3720,3943,7471,192,63,141.95,54.0,-1.16174,50.7265,8013.0
2241,2011,PO33 3,PO33 3,Total,9379,4475,4904,9180,199,130,584.98,16.0,-1.17742,50.7237,8873.0
2242,2011,PO33 4,PO33 4,Total,5329,2523,2806,5072,257,75,3469.73,1.5,-1.21817,50.7199,5381.0
2243,2011,PO34 5,PO34 5,Total,2083,985,1098,2077,6,38,278.22,7.5,-1.11404,50.7161,2004.0
2244,2011,PO35 5,PO35 5,Total,3688,1696,1992,3472,216,59,912.78,4.0,-1.0887,50.6878,3657.0
2245,2011,PO36 0,PO36 0,Total,4656,2272,2384,4640,16,57,3028.54,1.5,-1.1705,50.6682,4425.0
2246,2011,PO36 8,PO36 8,Total,5241,2545,2696,5038,203,57,308.55,17.0,-1.15357,50.6559,4917.0
2247,2011,PO36 9,PO36 9,Total,7061,3328,3733,6901,160,45,358.91,19.7,-1.16529,50.6527,7324.0
2248,2011,PO37 6,PO37 6,Total,3428,1678,1750,3131,297,33,510.17,6.7,-1.17739,50.6297,3593.0
2249,2011,PO37 7,PO37 7,Total,5644,2736,2908,5552,92,85,262.02,21.5,-1.1789,50.6363,5632.0
2250,2011,PO38 1,PO38 1,Total,5976,2888,3088,5792,184,54,819.79,7.3,-1.21029,50.595,5963.0
2251,2011,PO38 2,PO38 2,Total,2721,1338,1383,2718,3,45,2182.2,1.2,-1.28838,50.5984,2892.0
2252,2011,PO38 3,PO38 3,Total,3850,1871,1979,3847,3,36,3115.13,1.2,-1.24291,50.6281,3896.0
2253,2011,PO39 0,PO39 0,Total,2645,1263,1382,2473,172,25,529.21,5.0,-1.53943,50.6806,2532.0
2254,2011,PO40 9,PO40 9,Total,5436,2557,2879,5371,65,54,1311.13,4.1,-1.5222,50.6827,5519.0
2255,2011,PO41 0,PO41 0,Total,2021,978,1043,2019,2,35,2262.84,0.9,-1.47809,50.6999,2183.0
2256,2011,PR25 1,PR25 1,Total,8635,4186,4449,8557,78,72,344.49,25.1,-2.71314,53.6903,8552.0
2257,2011,PR25 2,PR25 2,Total,5154,2496,2658,5144,10,39,131.34,39.2,-2.69953,53.695,4607.0
2258,2011,PR25 3,PR25 3,Total,6738,3331,3407,6688,50,90,258.48,26.1,-2.69249,53.6944,7541.0
2259,2011,PR25 4,PR25 4,Total,5998,2886,3112,5970,28,46,435.65,13.8,-2.68378,53.6994,5869.0
2260,2011,PR25 5,PR25 5,Total,4256,2077,2179,4211,45,53,365.5,11.6,-2.67126,53.6978,4141.0
2261,2011,PR26 6,PR26 6,Total,2928,1489,1439,2898,30,29,737.26,4.0,-2.70917,53.7072,2720.0
2262,2011,PR26 7,PR26 7,Total,6402,3167,3235,6312,90,72,342.08,18.7,-2.72964,53.6931,6270.0
2263,2011,PR26 8,PR26 8,Total,2672,2261,411,790,1882,14,753.3,3.5,-2.73715,53.6803,2710.0
2264,2011,PR26 9,PR26 9,Total,3586,1749,1837,3541,45,58,1978.02,1.8,-2.77536,53.6687,3687.0
2265,2011,RG10 0,RG10 0,Total,5721,2810,2911,5721,0,118,2795.26,2.0,-0.854451,51.465,5919.0
2266,2011,RG10 8,RG10 8,Total,3648,1795,1853,3577,71,141,1589.08,2.3,-0.877161,51.4991,3473.0
2267,2011,RG10 9,RG10 9,Total,8887,4379,4508,8789,98,182,1689.95,5.3,-0.872544,51.4813,8787.0
2268,2011,RG12 0,RG12 0,Total,7477,3668,3809,7477,0,69,130.68,57.2,-0.741507,51.4014,7486.0
2269,2011,RG12 2,RG12 2,Total,5595,2776,2819,5532,63,79,167.75,33.4,-0.744622,51.4191,5535.0
2270,2011,RG12 7,RG12 7,Total,17418,8571,8847,17338,80,182,411.73,42.3,-0.756855,51.4019,17371.0
2271,2011,RG12 8,RG12 8,Total,11317,5540,5777,11317,0,153,469.72,24.1,-0.775294,51.4054,11450.0
2272,2011,RG12 9,RG12 9,Total,10076,5030,5046,10076,0,124,309.93,32.5,-0.739945,51.4092,10282.0
2273,2011,RG14 1,RG14 1,Total,6468,3147,3321,6408,60,103,310.46,20.8,-1.32838,51.4061,6301.0
2274,2011,RG14 2,RG14 2,Total,8257,4118,4139,8184,73,82,864.59,9.6,-1.30959,51.4093,8363.0
2275,2011,RG14 3,RG14 3,Total,883,452,431,622,261,27,1240.7,0.7,-1.329,51.4315,601.0
2276,2011,RG14 5,RG14 5,Total,4426,2275,2151,4410,16,41,176.85,25.0,-1.31958,51.3998,4430.0
2277,2011,RG14 6,RG14 6,Total,8651,4220,4431,8592,59,201,343.97,25.2,-1.33926,51.3871,8417.0
2278,2011,RG14 7,RG14 7,Total,9153,4561,4592,9094,59,147,285.32,32.1,-1.31746,51.3922,9586.0
2279,2011,RG17 0,RG17 0,Total,6130,2971,3159,6032,98,91,3643.21,1.7,-1.50729,51.4143,6398.0
2280,2011,RG17 7,RG17 7,Total,2475,1236,1239,2456,19,56,6601.23,0.4,-1.48983,51.4775,2569.0
2281,2011,RG17 8,RG17 8,Total,3100,1538,1562,3072,28,65,2581.69,1.2,-1.52772,51.5034,3026.0
2282,2011,RG17 9,RG17 9,Total,3389,1697,1692,3342,47,107,4781.64,0.7,-1.45848,51.3918,3210.0
2283,2011,RG18 0,RG18 0,Total,1201,615,586,1200,1,23,2334.79,0.5,-1.2143,51.4727,1208.0
2284,2011,RG18 3,RG18 3,Total,6783,3368,3415,6743,40,82,275.32,24.6,-1.25329,51.4103,7111.0
2285,2011,RG18 4,RG18 4,Total,4792,2379,2413,4726,66,86,453.36,10.6,-1.23845,51.409,4867.0
2286,2011,RG18 9,RG18 9,Total,6280,2948,3332,5602,678,161,2166.14,2.9,-1.2581,51.4417,6539.0
2287,2011,RG19 3,RG19 3,Total,7220,3626,3594,7215,5,80,295.21,24.5,-1.24242,51.4057,7051.0
2288,2011,RG19 4,RG19 4,Total,7222,3668,3554,7113,109,123,1284.47,5.6,-1.23416,51.4007,6465.0
2289,2011,RG19 8,RG19 8,Total,3214,1572,1642,3162,52,69,2638.17,1.2,-1.25435,51.3732,3400.0
2290,2011,RG20 0,RG20 0,Total,2221,1103,1118,2220,1,96,4831.13,0.5,-1.39037,51.3728,2059.0
2291,2011,RG20 4,RG20 4,Total,1048,520,528,1048,0,38,1797.46,0.6,-1.28026,51.3526,1227.0
2292,2011,RG20 5,RG20 5,Total,3164,1550,1614,3164,0,57,1515.73,2.1,-1.25894,51.3375,3033.0
2293,2011,RG20 6,RG20 6,Total,1571,816,755,1557,14,34,1502.19,1.0,-1.25718,51.5036,1442.0
2294,2011,RG20 7,RG20 7,Total,2046,996,1050,2035,11,70,5525.7,0.4,-1.33124,51.505,2092.0
2295,2011,RG20 8,RG20 8,Total,3653,1812,1841,3596,57,123,7472.16,0.5,-1.35804,51.4458,4039.0
2296,2011,RG20 9,RG20 9,Total,5181,2579,2602,4974,207,211,5283.61,1.0,-1.3516,51.3524,5364.0
2297,2011,RG21 3,RG21 3,Total,7907,3956,3951,7847,60,125,317.07,24.9,-1.08863,51.2576,7613.0
2298,2011,RG21 4,RG21 4,Total,3136,1617,1519,3133,3,36,240.77,13.0,-1.08418,51.2697,3257.0
2299,2011,RG21 5,RG21 5,Total,7787,3765,4022,7642,145,56,259.15,30.0,-1.08879,51.2743,7748.0
2300,2011,RG21 6,RG21 6,Total,506,266,240,506,0,7,15.77,32.1,-1.1025,51.2723,466.0
2301,2011,RG21 7,RG21 7,Total,3632,1943,1689,3616,16,19,38.83,93.5,-1.09196,51.2666,3819.0
2302,2011,RG21 8,RG21 8,Total,3959,1972,1987,3914,45,42,106.51,37.2,-1.09929,51.2646,3921.0
2303,2011,RG22 4,RG22 4,Total,20955,10337,10618,20955,0,304,483.84,43.3,-1.11815,51.2468,21068.0
2304,2011,RG22 5,RG22 5,Total,10435,5123,5312,10424,11,140,341.29,30.6,-1.13481,51.2529,10882.0
2305,2011,RG22 6,RG22 6,Total,10372,5030,5342,10319,53,82,279.27,37.1,-1.11655,51.2583,10036.0
2306,2011,RG23 7,RG23 7,Total,5288,2588,2700,5244,44,123,2296.24,2.3,-1.1667,51.2486,5281.0
2307,2011,RG23 8,RG23 8,Total,6981,3462,3519,6931,50,86,1065.93,6.5,-1.12551,51.2709,6833.0
2308,2011,RG24 7,RG24 7,Total,4041,1960,2081,3987,54,75,1472.53,2.7,-1.04803,51.2701,4070.0
2309,2011,RG24 8,RG24 8,Total,11200,5563,5637,11198,2,226,438.63,25.5,-1.06766,51.2855,11464.0
2310,2011,RG24 9,RG24 9,Total,16015,7888,8127,15803,212,126,1845.52,8.7,-1.09995,51.2838,15954.0
2311,2011,RG25 2,RG25 2,Total,4183,2110,2073,4171,12,138,11005.74,0.4,-1.09506,51.2219,3913.0
2312,2011,RG25 3,RG25 3,Total,4522,2250,2272,4472,50,89,4467.89,1.0,-1.25742,51.2442,4582.0
2313,2011,RG26 3,RG26 3,Total,8445,4262,4183,8372,73,134,1099.28,7.7,-1.12744,51.3545,8204.0
2314,2011,RG26 4,RG26 4,Total,4553,2293,2260,4523,30,57,190.23,23.9,-1.13837,51.3606,4868.0
2315,2011,RG26 5,RG26 5,Total,9135,4530,4605,9084,51,206,7400.48,1.2,-1.11325,51.3361,9301.0
2316,2011,RG27 0,RG27 0,Total,5473,2729,2744,5420,53,139,5311.3,1.0,-0.967219,51.3241,5190.0
2317,2011,RG27 8,RG27 8,Total,6525,3207,3318,6460,65,186,4683.56,1.4,-0.913251,51.2983,6589.0
2318,2011,RG27 9,RG27 9,Total,9028,4447,4581,8849,179,264,2695.83,3.3,-0.963534,51.283,8907.0
2319,2011,RG28 7,RG28 7,Total,5786,2800,2986,5729,57,162,7445.29,0.8,-1.33161,51.2346,5766.0
2320,2011,RG29 1,RG29 1,Total,7143,3805,3338,6164,979,189,4717.91,1.5,-0.9473,51.2489,7198.0
2321,2011,RG30 1,RG30 1,Total,4940,2511,2429,4940,0,33,205.4,24.1,-0.998729,51.4595,5084.0
2322,2011,RG30 2,RG30 2,Total,12408,6361,6047,12173,235,102,162.75,76.2,-1.00104,51.4544,12915.0
2323,2011,RG30 3,RG30 3,Total,8542,4080,4462,8482,60,117,1663.85,5.1,-1.01496,51.4371,8539.0
2324,2011,RG30 4,RG30 4,Total,12010,5776,6234,11956,54,126,336.35,35.7,-1.02322,51.4544,11049.0
2325,2011,RG30 6,RG30 6,Total,6231,3011,3220,6108,123,72,124.7,50.0,-1.02102,51.4632,6144.0
2326,2011,RG31 4,RG31 4,Total,4468,2181,2287,4468,0,59,164.73,27.1,-1.04522,51.4485,4572.0
2327,2011,RG31 5,RG31 5,Total,6676,3236,3440,6664,12,128,205.45,32.5,-1.045,51.4583,7057.0
2328,2011,RG31 6,RG31 6,Total,9562,4748,4814,9538,24,214,352.08,27.2,-1.03928,51.4687,9926.0
2329,2011,RG31 7,RG31 7,Total,6570,3245,3325,6559,11,120,276.54,23.8,-1.03328,51.4437,6441.0
2330,2011,RG40 1,RG40 1,Total,7704,3649,4055,7596,108,113,307.18,25.1,-0.826265,51.4138,7738.0
2331,2011,RG40 2,RG40 2,Total,4558,2228,2330,4450,108,103,231.19,19.7,-0.830056,51.4086,4370.0
2332,2011,RG40 3,RG40 3,Total,4640,2406,2234,4437,203,183,1467.93,3.2,-0.832176,51.3865,5283.0
2333,2011,RG40 4,RG40 4,Total,7794,3842,3952,7739,55,207,1156.54,6.7,-0.863562,51.3828,7439.0
2334,2011,RG40 5,RG40 5,Total,1784,896,888,1784,0,41,786.21,2.3,-0.823754,51.4235,1895.0
2335,2011,RG41 1,RG41 1,Total,3739,1916,1823,3739,0,86,234.63,15.9,-0.847326,51.4212,3859.0
2336,2011,RG41 2,RG41 2,Total,4756,2287,2469,4589,167,94,224.38,21.2,-0.843882,51.4075,4456.0
2337,2011,RG41 3,RG41 3,Total,6530,3197,3333,6530,0,185,174.13,37.5,-0.855216,51.4133,6623.0
2338,2011,RG41 4,RG41 4,Total,3917,1892,2025,3917,0,126,666.21,5.9,-0.860105,51.4021,4017.0
2339,2011,RG41 5,RG41 5,Total,9284,4552,4732,9103,181,185,953.3,9.7,-0.870209,51.4256,9275.0
2340,2011,RG42 1,RG42 1,Total,4670,2295,2375,4670,0,52,188.2,24.8,-0.768596,51.4199,4804.0
2341,2011,RG42 2,RG42 2,Total,6382,3148,3234,6382,0,82,146.24,43.6,-0.754602,51.4236,5900.0
2342,2011,RG42 3,RG42 3,Total,5889,2837,3052,5885,4,105,165.49,35.6,-0.734342,51.4234,5990.0
2343,2011,RG42 4,RG42 4,Total,4279,2099,2180,4154,125,92,425.38,10.1,-0.781404,51.4255,4414.0
2344,2011,RG42 5,RG42 5,Total,1652,818,834,1652,0,54,772.56,2.1,-0.777523,51.438,1644.0
2345,2011,RG42 6,RG42 6,Total,1429,720,709,1421,8,64,1184.34,1.2,-0.73396,51.4379,1543.0
2346,2011,RG42 7,RG42 7,Total,1740,859,881,1740,0,24,101.0,17.2,-0.721851,51.4251,1491.0
2347,2011,RG45 6,RG45 6,Total,8596,4240,4356,8390,206,240,559.97,15.4,-0.805428,51.3803,8525.0
2348,2011,RG45 7,RG45 7,Total,5969,3127,2842,5059,910,176,1427.48,4.2,-0.795919,51.372,5695.0
2349,2011,RH10 1,RH10 1,Total,6705,3382,3323,6632,73,41,187.5,35.8,-0.179747,51.1171,7042.0
2350,2011,RH10 3,RH10 3,Total,12129,6123,6006,11940,189,203,1213.13,10.0,-0.140084,51.1322,12292.0
2351,2011,RH10 4,RH10 4,Total,7087,3593,3494,6766,321,154,2838.15,2.5,-0.112502,51.1172,7153.0
2352,2011,RH10 5,RH10 5,Total,6078,2937,3141,6078,0,53,283.06,21.5,-0.182564,51.1029,6109.0
2353,2011,RH10 6,RH10 6,Total,9542,4678,4864,9460,82,100,314.5,30.3,-0.179541,51.1088,9734.0
2354,2011,RH10 7,RH10 7,Total,17613,8727,8886,17599,14,223,391.69,45.0,-0.155708,51.112,17532.0
2355,2011,RH10 8,RH10 8,Total,6065,3114,2951,6065,0,45,498.95,12.2,-0.182022,51.1226,6004.0
2356,2011,RH11 0,RH11 0,Total,9527,4617,4910,9296,231,96,1085.37,8.8,-0.211599,51.1217,9569.0
2357,2011,RH11 6,RH11 6,Total,2838,1408,1430,2838,0,34,66.78,42.5,-0.222337,51.1056,2592.0
2358,2011,RH11 7,RH11 7,Total,13156,6623,6533,12984,172,89,1278.33,10.3,-0.196015,51.1223,12630.0
2359,2011,RH11 8,RH11 8,Total,15769,7728,8041,15605,164,170,306.88,51.4,-0.20759,51.1089,15820.0
2360,2011,RH11 9,RH11 9,Total,14526,7057,7469,14455,71,136,2060.81,7.0,-0.201189,51.0983,14182.0
2361,2011,RH12 1,RH12 1,Total,7208,3505,3703,7109,99,109,303.72,23.7,-0.333259,51.0631,7169.0
2362,2011,RH12 2,RH12 2,Total,7673,3738,3935,7564,109,133,300.82,25.5,-0.329384,51.0706,7559.0
2363,2011,RH12 3,RH12 3,Total,8688,4201,4487,8327,361,233,6045.1,1.4,-0.38375,51.0812,8470.0
2364,2011,RH12 4,RH12 4,Total,10069,4902,5167,10003,66,127,3882.46,2.6,-0.298887,51.083,10585.0
2365,2011,RH12 5,RH12 5,Total,10138,4860,5278,10079,59,185,238.12,42.6,-0.316301,51.0785,10079.0
2366,2011,RH13 0,RH13 0,Total,5064,2526,2538,4165,899,172,3243.55,1.6,-0.379161,51.0503,5255.0
2367,2011,RH13 5,RH13 5,Total,9331,4546,4785,9207,124,131,195.08,47.8,-0.315216,51.0644,9528.0
2368,2011,RH13 6,RH13 6,Total,8314,4027,4287,8219,95,202,3979.05,2.1,-0.296496,51.0545,8103.0
2369,2011,RH13 8,RH13 8,Total,6370,3155,3215,6262,108,160,7690.62,0.8,-0.317465,50.9858,6146.0
2370,2011,RH13 9,RH13 9,Total,9029,4527,4502,9029,0,167,1018.46,8.9,-0.344367,51.032,8991.0
2371,2011,RH14 0,RH14 0,Total,5855,2867,2988,5855,0,201,7691.26,0.8,-0.517907,51.0445,5721.0
2372,2011,RH14 9,RH14 9,Total,8232,4053,4179,8172,60,139,3219.23,2.6,-0.45044,51.0214,8454.0
2373,2011,RH15 0,RH15 0,Total,10988,5286,5702,10621,367,148,992.09,11.1,-0.121345,50.9559,10930.0
2374,2011,RH15 8,RH15 8,Total,11652,5625,6027,11517,135,154,1284.09,9.1,-0.139333,50.961,11592.0
2375,2011,RH15 9,RH15 9,Total,8905,4406,4499,8847,58,101,299.96,29.7,-0.144618,50.9542,8764.0
2376,2011,RH16 1,RH16 1,Total,7049,3490,3559,6969,80,160,344.59,20.5,-0.105846,51.0075,7185.0
2377,2011,RH16 2,RH16 2,Total,7255,3471,3784,7148,107,167,1286.5,5.6,-0.0845811,51.0095,7109.0
2378,2011,RH16 3,RH16 3,Total,10173,4903,5270,10133,40,113,273.76,37.2,-0.0964685,51.0013,9890.0
2379,2011,RH16 4,RH16 4,Total,9073,4459,4614,8879,194,93,275.88,32.9,-0.106364,50.9928,9746.0
2380,2011,RH17 5,RH17 5,Total,6813,3293,3520,6642,171,203,5781.69,1.2,-0.159219,51.0047,6685.0
2381,2011,RH17 6,RH17 6,Total,5477,2768,2709,5116,361,113,4989.81,1.1,-0.139629,51.048,5887.0
2382,2011,RH17 7,RH17 7,Total,6973,3416,3557,6792,181,212,5856.09,1.2,-0.0518768,51.0095,6384.0
2383,2011,RH18 5,RH18 5,Total,4453,2125,2328,4431,22,136,1994.11,2.2,0.0251586,51.1008,4558.0
2384,2011,RH19 1,RH19 1,Total,7145,3497,3648,7048,97,133,298.76,23.9,-0.0191276,51.1282,6858.0
2385,2011,RH19 2,RH19 2,Total,7202,3522,3680,7146,56,148,1108.76,6.5,-0.0238177,51.137,7287.0
2386,2011,RH19 3,RH19 3,Total,11043,5464,5579,10749,294,196,2115.01,5.2,0.00324629,51.1271,11218.0
2387,2011,RH19 4,RH19 4,Total,8089,3979,4110,7874,215,190,3464.4,2.3,-0.0176866,51.1122,8276.0
2388,2011,RH20 1,RH20 1,Total,5013,2431,2582,4899,114,163,6909.57,0.7,-0.535153,50.9529,4869.0
2389,2011,RH20 2,RH20 2,Total,6780,3265,3515,6737,43,171,3982.44,1.7,-0.479718,50.953,6908.0
2390,2011,RH20 3,RH20 3,Total,6428,3180,3248,6426,2,128,2623.07,2.5,-0.425648,50.9261,6409.0
2391,2011,RH20 4,RH20 4,Total,6747,3204,3543,6504,243,99,2740.86,2.5,-0.451666,50.9173,6568.0
2392,2011,RM10 7,RM10 7,Total,10993,5192,5801,10864,129,75,175.47,62.6,0.156278,51.5544,11382.0
2393,2011,RM10 8,RM10 8,Total,14801,7196,7605,14767,34,141,239.4,61.8,0.15731,51.5446,14157.0
2394,2011,RM10 9,RM10 9,Total,12387,5923,6464,12261,126,120,381.44,32.5,0.156024,51.5372,12618.0
2395,2011,RM11 1,RM11 1,Total,11559,5532,6027,11507,52,168,247.77,46.7,0.207147,51.5661,10933.0
2396,2011,RM11 2,RM11 2,Total,9622,4616,5006,9580,42,115,223.72,43.0,0.218819,51.5762,10271.0
2397,2011,RM11 3,RM11 3,Total,10596,5117,5479,10511,85,166,409.1,25.9,0.229223,51.5674,10135.0
2398,2011,RM12 4,RM12 4,Total,16114,7844,8270,16013,101,159,382.93,42.1,0.202932,51.5581,16176.0
2399,2011,RM12 5,RM12 5,Total,9824,4703,5121,9824,0,97,199.74,49.2,0.202344,51.5465,9659.0
2400,2011,RM12 6,RM12 6,Total,8302,3952,4350,8302,0,85,227.03,36.6,0.219759,51.5537,8828.0
2401,2011,RM13 7,RM13 7,Total,9035,4275,4760,8990,45,80,224.43,40.3,0.190549,51.5341,9165.0
2402,2011,RM13 8,RM13 8,Total,7399,3747,3652,7392,7,61,456.99,16.2,0.180364,51.5233,7375.0
2403,2011,RM13 9,RM13 9,Total,12482,6019,6463,12457,25,111,1534.21,8.1,0.202885,51.5184,12473.0
2404,2011,RM14 1,RM14 1,Total,11267,5352,5915,11245,22,152,912.73,12.3,0.262522,51.5652,11173.0
2405,2011,RM14 2,RM14 2,Total,8350,4011,4339,8248,102,103,406.85,20.5,0.245186,51.5509,8424.0
2406,2011,RM14 3,RM14 3,Total,7413,3615,3798,7292,121,135,4393.97,1.7,0.283681,51.5523,7312.0
2407,2011,RM15 4,RM15 4,Total,7986,3945,4041,7973,13,49,919.51,8.7,0.253108,51.5021,7995.0
2408,2011,RM15 5,RM15 5,Total,11192,5564,5628,11150,42,63,379.38,29.5,0.282692,51.5099,10915.0
2409,2011,RM15 6,RM15 6,Total,8268,4070,4198,8252,16,58,1400.79,5.9,0.293016,51.5147,8534.0
2410,2011,RM16 2,RM16 2,Total,12230,6015,6215,12215,15,142,505.68,24.2,0.334837,51.4941,12107.0
2411,2011,RM16 3,RM16 3,Total,3587,1748,1839,3535,52,51,1269.21,2.8,0.364782,51.5044,3535.0
2412,2011,RM16 4,RM16 4,Total,9864,4718,5146,9744,120,48,358.75,27.5,0.366244,51.4858,10068.0
2413,2011,RM16 5,RM16 5,Total,758,378,380,744,14,9,119.39,6.3,0.303574,51.4982,758.0
2414,2011,RM16 6,RM16 6,Total,14697,7317,7380,14691,6,144,254.17,57.8,0.305322,51.4867,14697.0
2415,2011,RM17 5,RM17 5,Total,12354,6222,6132,12294,60,125,356.4,34.7,0.325439,51.4829,12931.0
2416,2011,RM17 6,RM17 6,Total,15051,7559,7492,14924,127,96,266.43,56.5,0.329556,51.4766,14379.0
2417,2011,RM18 7,RM18 7,Total,4728,2248,2480,4664,64,30,442.9,10.7,0.35279,51.4627,4667.0
2418,2011,RM18 8,RM18 8,Total,11936,5847,6089,11934,2,79,2047.33,5.8,0.382602,51.4711,12061.0
2419,2011,RM19 1,RM19 1,Total,6527,3265,3262,6526,1,41,479.87,13.6,0.252317,51.4825,6532.0
2420,2011,RM20 3,RM20 3,Total,1958,1009,949,1958,0,8,596.57,3.3,0.279218,51.4782,1843.0
2421,2011,RM20 4,RM20 4,Total,2919,1508,1411,2919,0,18,65.12,44.8,0.300282,51.4774,3139.0
2422,2011,SE10 0,SE10 0,Total,7819,3888,3931,7815,4,62,241.03,32.4,0.0110423,51.4917,7978.0
2423,2011,SE10 8,SE10 8,Total,7517,3793,3724,7453,64,73,175.78,42.8,-0.00890225,51.4766,7837.0
2424,2011,SE10 9,SE10 9,Total,8651,4263,4388,8336,315,48,97.35,88.9,-0.00328736,51.4831,8528.0
2425,2011,SE11 4,SE11 4,Total,8860,4615,4245,8398,462,95,75.48,117.4,-0.105406,51.4896,9048.0
2426,2011,SE11 5,SE11 5,Total,7300,3795,3505,7300,0,71,74.51,98.0,-0.112756,51.4874,6900.0
2427,2011,SE11 6,SE11 6,Total,5814,2879,2935,5778,36,75,44.79,129.8,-0.112645,51.4923,5645.0
2428,2011,SE12 0,SE12 0,Total,8642,4218,4424,8603,39,71,146.98,58.8,0.0222176,51.4429,9085.0
2429,2011,SE12 8,SE12 8,Total,7958,3895,4063,7958,0,98,143.84,55.3,0.022143,51.4534,8379.0
2430,2011,SE12 9,SE12 9,Total,10543,5010,5533,10533,10,135,191.21,55.1,0.0306705,51.4413,9891.0
2431,2011,SE13 5,SE13 5,Total,12725,6378,6347,12573,152,118,132.58,96.0,-0.00482606,51.4595,12091.0
2432,2011,SE13 6,SE13 6,Total,11961,6035,5926,11824,137,94,123.31,97.0,-0.00945862,51.4547,12365.0
2433,2011,SE13 7,SE13 7,Total,17592,8898,8694,17460,132,175,179.65,97.9,-0.0158705,51.4633,16961.0
2434,2011,SE14 5,SE14 5,Total,15038,7701,7337,14921,117,181,162.7,92.4,-0.0471089,51.4752,14965.0
2435,2011,SE14 6,SE14 6,Total,9641,4720,4921,8745,896,94,102.86,93.7,-0.0381902,51.476,9816.0
2436,2011,SE15 1,SE15 1,Total,7119,3459,3660,7106,13,94,65.96,107.9,-0.0616411,51.4791,7441.0
2437,2011,SE15 2,SE15 2,Total,12538,6302,6236,12376,162,122,94.94,132.1,-0.0608773,51.4731,12479.0
2438,2011,SE15 3,SE15 3,Total,14373,6895,7478,14261,112,138,158.53,90.7,-0.0597027,51.4646,14124.0
2439,2011,SE15 4,SE15 4,Total,8383,4066,4317,8282,101,70,73.85,113.5,-0.0705898,51.4677,8396.0
2440,2011,SE15 5,SE15 5,Total,9579,4717,4862,9549,30,107,77.54,123.5,-0.0715354,51.4736,9747.0
2441,2011,SE15 6,SE15 6,Total,12367,6007,6360,12313,54,139,88.67,139.5,-0.0751768,51.4788,11947.0
2442,2011,SE16 2,SE16 2,Total,10116,4857,5259,9950,166,100,93.59,108.1,-0.0553876,51.4926,10312.0
2443,2011,SE16 3,SE16 3,Total,10229,4921,5308,10229,0,91,90.82,112.6,-0.0658755,51.4911,10627.0
2444,2011,SE16 4,SE16 4,Total,6665,3347,3318,6661,4,48,52.76,126.3,-0.0653018,51.4981,6853.0
2445,2011,SE16 5,SE16 5,Total,6352,3279,3073,6341,11,42,53.29,119.2,-0.0485562,51.5017,6150.0
2446,2011,SE16 6,SE16 6,Total,4915,2484,2431,4914,1,49,56.6,86.8,-0.0478372,51.4999,4581.0
2447,2011,SE16 7,SE16 7,Total,6680,3400,3280,6662,18,36,85.65,78.0,-0.0493858,51.4963,7341.0
2448,2011,SE17 1,SE17 1,Total,7836,3865,3971,7834,2,66,49.92,157.0,-0.0936532,51.491,7111.0
2449,2011,SE17 2,SE17 2,Total,13729,6787,6942,13695,34,143,78.92,174.0,-0.0899261,51.4872,14151.0
2450,2011,SE17 3,SE17 3,Total,12026,6009,6017,11881,145,102,72.55,165.8,-0.100085,51.4872,11604.0
2451,2011,SE18 1,SE18 1,Total,14635,7652,6983,14635,0,120,146.28,100.0,0.0873411,51.4869,14683.0
2452,2011,SE18 2,SE18 2,Total,10055,5048,5007,10044,11,82,237.35,42.4,0.0862359,51.4791,10120.0
2453,2011,SE18 3,SE18 3,Total,11788,5827,5961,11730,58,147,225.05,52.4,0.0687444,51.4792,12091.0
2454,2011,SE18 4,SE18 4,Total,7685,3926,3759,7298,387,68,195.07,39.4,0.0559685,51.4783,8469.0
2455,2011,SE18 5,SE18 5,Total,10374,5209,5165,10303,71,88,83.04,124.9,0.0547948,51.4909,10428.0
2456,2011,SE18 6,SE18 6,Total,9766,5074,4692,9766,0,66,110.73,88.2,0.0682106,51.4902,9370.0
2457,2011,SE18 7,SE18 7,Total,13081,6531,6550,12997,84,154,108.13,121.0,0.0760624,51.4871,12734.0
2458,2011,SE19 1,SE19 1,Total,8804,4170,4634,8767,37,87,99.97,88.1,-0.0836527,51.422,8855.0
2459,2011,SE19 2,SE19 2,Total,7789,3889,3900,7719,70,70,167.85,46.4,-0.0799782,51.4156,7774.0
2460,2011,SE19 3,SE19 3,Total,11057,5329,5728,10927,130,142,178.68,61.9,-0.0914465,51.4171,11010.0
2461,2011,SE20 7,SE20 7,Total,11585,5590,5995,11557,28,119,139.68,82.9,-0.0548585,51.4128,11503.0
2462,2011,SE20 8,SE20 8,Total,11296,5503,5793,11153,143,91,141.62,79.8,-0.0616953,51.4131,11318.0
2463,2011,SE21 7,SE21 7,Total,3902,1960,1942,3738,164,167,252.23,15.5,-0.0846865,51.4426,3828.0
2464,2011,SE21 8,SE21 8,Total,11357,5435,5922,11332,25,197,181.68,62.5,-0.0904627,51.4364,11429.0
2465,2011,SE22 0,SE22 0,Total,10440,4990,5450,10351,89,123,167.27,62.4,-0.0680862,51.4521,10396.0
2466,2011,SE22 8,SE22 8,Total,10659,4992,5667,10627,32,146,132.44,80.5,-0.0765814,51.4555,10864.0
2467,2011,SE22 9,SE22 9,Total,8639,4157,4482,8624,15,71,64.2,134.6,-0.0720773,51.4565,8427.0
2468,2011,SE23 1,SE23 1,Total,8639,4196,4443,8611,28,80,97.97,88.2,-0.0451994,51.4437,8762.0
2469,2011,SE23 2,SE23 2,Total,12961,6458,6503,12916,45,155,138.26,93.7,-0.0474888,51.4366,13398.0
2470,2011,SE23 3,SE23 3,Total,11889,5930,5959,11856,33,142,184.94,64.3,-0.0554914,51.4413,11527.0
2471,2011,SE24 0,SE24 0,Total,9256,4561,4695,9235,21,109,140.5,65.9,-0.102221,51.4581,9109.0
2472,2011,SE24 9,SE24 9,Total,9658,4657,5001,9638,20,171,127.38,75.8,-0.0987931,51.4532,9652.0
2473,2011,SE25 4,SE25 4,Total,12515,5868,6647,12515,0,149,190.89,65.6,-0.0717632,51.3988,12875.0
2474,2011,SE25 5,SE25 5,Total,9473,4616,4857,9450,23,79,145.58,65.1,-0.076661,51.3945,8949.0
2475,2011,SE25 6,SE25 6,Total,12698,6134,6564,12611,87,140,151.73,83.7,-0.0830484,51.4001,12697.0
2476,2011,SE26 4,SE26 4,Total,9781,4752,5029,9708,73,121,109.11,89.6,-0.0520453,51.4296,9447.0
2477,2011,SE26 5,SE26 5,Total,7941,3918,4023,7853,88,71,109.0,72.9,-0.0466639,51.4249,8387.0
2478,2011,SE26 6,SE26 6,Total,10656,5044,5612,10480,176,125,170.47,62.5,-0.0624417,51.4279,10727.0
2479,2011,SE27 0,SE27 0,Total,12554,6048,6506,12368,186,142,121.1,103.7,-0.104382,51.4296,12457.0
2480,2011,SE27 9,SE27 9,Total,9282,4433,4849,9278,4,131,125.35,74.0,-0.0987642,51.4315,8955.0
2481,2011,SE28 0,SE28 0,Total,11234,5947,5287,10341,893,100,233.71,48.1,0.0907312,51.4975,11368.0
2482,2011,SE28 8,SE28 8,Total,18254,8880,9374,18128,126,231,275.67,66.2,0.114292,51.5043,18021.0
2483,2011,SG10 6,SG10 6,Total,2087,987,1100,1914,173,58,1816.09,1.1,0.0660681,51.843,2089.0
2484,2011,SG11 1,SG11 1,Total,5014,2512,2502,4871,143,81,3684.91,1.4,0.00128264,51.8716,5226.0
2485,2011,SG11 2,SG11 2,Total,2955,1469,1486,2955,0,69,4337.71,0.7,0.0569367,51.8834,2862.0
2486,2011,SG12 0,SG12 0,Total,9464,4746,4718,9433,31,166,4378.08,2.2,-0.0435769,51.8291,9207.0
2487,2011,SG12 7,SG12 7,Total,8788,4295,4493,8638,150,126,1501.8,5.9,-0.0141463,51.815,9037.0
2488,2011,SG12 8,SG12 8,Total,6471,3165,3306,6380,91,102,2619.19,2.5,0.0191784,51.8006,6310.0
2489,2011,SG12 9,SG12 9,Total,5344,2600,2744,5248,96,95,459.18,11.6,-0.0268079,51.8056,5157.0
2490,2011,SG13 7,SG13 7,Total,10747,5364,5383,10282,465,239,845.07,12.7,-0.0587496,51.7953,10717.0
2491,2011,SG13 8,SG13 8,Total,5896,2909,2987,5891,5,168,3712.73,1.6,-0.0881715,51.7785,5546.0
2492,2011,SG14 1,SG14 1,Total,2521,1261,1260,2521,0,20,74.39,33.9,-0.0790691,51.7968,2755.0
2493,2011,SG14 2,SG14 2,Total,7248,3518,3730,7229,19,128,2196.97,3.3,-0.104289,51.8029,7599.0
2494,2011,SG14 3,SG14 3,Total,9029,4349,4680,8981,48,180,2366.8,3.8,-0.0897692,51.8174,8756.0
2495,2011,SG15 6,SG15 6,Total,5584,2765,2819,5522,62,60,948.68,5.9,-0.262428,52.0116,5584.0
2496,2011,SG16 6,SG16 6,Total,6110,3070,3040,5953,157,90,1703.11,3.6,-0.299322,52.0133,6091.0
2497,2011,SG17 5,SG17 5,Total,12203,6034,6169,11868,335,202,2557.13,4.8,-0.331371,52.0346,12320.0
2498,2011,SG18 0,SG18 0,Total,7559,3693,3866,7491,68,65,509.28,14.8,-0.259593,52.0913,7630.0
2499,2011,SG18 8,SG18 8,Total,9688,4794,4894,9656,32,114,2899.16,3.3,-0.24803,52.0839,9531.0
2500,2011,SG18 9,SG18 9,Total,6881,3452,3429,6834,47,92,6119.44,1.1,-0.286768,52.0736,6777.0
2501,2011,SG19 1,SG19 1,Total,9649,4799,4850,9576,73,96,1716.13,5.6,-0.290678,52.1305,9605.0
2502,2011,SG19 2,SG19 2,Total,9422,4675,4747,9416,6,120,6186.82,1.5,-0.242183,52.133,9470.0
2503,2011,SG19 3,SG19 3,Total,5026,2502,2524,5025,1,92,5613.15,0.9,-0.18782,52.1592,5124.0
2504,2011,SK10 1,SK10 1,Total,3206,1542,1664,3191,15,42,123.04,26.1,-2.12204,53.2609,3169.0
2505,2011,SK10 2,SK10 2,Total,10749,5330,5419,10745,4,236,630.83,17.0,-2.12323,53.2717,10632.0
2506,2011,SK10 3,SK10 3,Total,10347,5046,5301,10126,221,223,489.62,21.1,-2.1502,53.2652,9972.0
2507,2011,SK10 4,SK10 4,Total,6390,3063,3327,6217,173,229,5599.62,1.1,-2.16181,53.2879,6374.0
2508,2011,SK10 5,SK10 5,Total,9112,4486,4626,9024,88,154,3596.19,2.5,-2.09843,53.291,9233.0
2509,2011,SK11 0,SK11 0,Total,4208,2077,2131,4116,92,75,10420.59,0.4,-2.10126,53.2199,4433.0
2510,2011,SK11 6,SK11 6,Total,3687,1868,1819,3687,0,43,60.91,60.5,-2.12712,53.2583,3478.0
2511,2011,SK11 7,SK11 7,Total,11697,5708,5989,11568,129,139,560.13,20.9,-2.12494,53.2515,11460.0
2512,2011,SK11 8,SK11 8,Total,12796,6180,6616,12660,136,169,301.81,42.4,-2.14234,53.2556,13491.0
2513,2011,SK11 9,SK11 9,Total,4159,2052,2107,4159,0,95,7368.27,0.6,-2.2265,53.2442,4026.0
2514,2011,SK12 1,SK12 1,Total,14260,6922,7338,14125,135,300,1201.08,11.9,-2.12557,53.3493,14305.0
2515,2011,SK12 2,SK12 2,Total,4812,2348,2464,4738,74,93,2448.16,2.0,-2.03655,53.3582,4744.0
2516,2011,SK13 0,SK13 0,Total,1943,925,1018,1943,0,15,76.79,25.3,-1.98725,53.4476,1940.0
2517,2011,SK13 1,SK13 1,Total,6899,3363,3536,6818,81,82,5014.22,1.4,-1.96825,53.4656,6697.0
2518,2011,SK13 2,SK13 2,Total,3700,1812,1888,3663,37,37,167.42,22.1,-1.97965,53.458,3758.0
2519,2011,SK13 5,SK13 5,Total,1437,697,740,1437,0,32,817.63,1.8,-1.99361,53.4323,1420.0
2520,2011,SK13 6,SK13 6,Total,6113,3034,3079,6058,55,94,264.2,23.1,-1.97103,53.4423,5957.0
2521,2011,SK13 7,SK13 7,Total,3872,1874,1998,3842,30,68,5935.53,0.7,-1.94865,53.4476,4029.0
2522,2011,SK13 8,SK13 8,Total,9126,4502,4624,9090,36,117,326.88,27.9,-1.94642,53.4415,9303.0
2523,2011,SK14 1,SK14 1,Total,5911,2935,2976,5854,57,29,118.97,49.7,-2.07818,53.4493,5312.0
2524,2011,SK14 2,SK14 2,Total,4141,2034,2107,4074,67,33,120.08,34.5,-2.07511,53.4528,4701.0
2525,2011,SK14 3,SK14 3,Total,6487,3154,3333,6487,0,50,799.54,8.1,-2.04246,53.4487,6316.0
2526,2011,SK14 4,SK14 4,Total,12573,6162,6411,12529,44,81,386.97,32.5,-2.07379,53.4607,12592.0
2527,2011,SK14 5,SK14 5,Total,9854,4741,5113,9699,155,84,341.73,28.8,-2.07263,53.4417,10058.0
2528,2011,SK14 6,SK14 6,Total,4389,2167,2222,4375,14,45,498.55,8.8,-2.0162,53.4479,4557.0
2529,2011,SK14 8,SK14 8,Total,2878,1423,1455,2866,12,32,405.71,7.1,-1.9882,53.46,2772.0
2530,2011,SK15 1,SK15 1,Total,8991,4460,4531,8867,124,48,267.96,33.6,-2.06382,53.4859,9144.0
2531,2011,SK15 2,SK15 2,Total,9184,4562,4622,9146,38,124,483.1,19.0,-2.04928,53.4794,9115.0
2532,2011,SK15 3,SK15 3,Total,9249,4552,4697,9179,70,85,1760.99,5.3,-2.03581,53.4954,9366.0
2533,2011,SK16 4,SK16 4,Total,8400,4149,4251,8335,65,45,276.62,30.4,-2.09023,53.4744,8449.0
2534,2011,SK16 5,SK16 5,Total,11245,5538,5707,11125,120,70,287.89,39.1,-2.07292,53.471,11026.0
2535,2011,SK17 0,SK17 0,Total,2935,1461,1474,2902,33,31,14229.82,0.2,-1.8735,53.1711,2872.0
2536,2011,SK17 6,SK17 6,Total,8296,4092,4204,7818,478,156,1452.74,5.7,-1.91814,53.2576,7912.0
2537,2011,SK17 7,SK17 7,Total,7427,3622,3805,7399,28,70,1061.82,7.0,-1.8991,53.261,7753.0
2538,2011,SK17 8,SK17 8,Total,5515,2808,2707,5512,3,81,9230.44,0.6,-1.8164,53.285,5249.0
2539,2011,SK17 9,SK17 9,Total,8034,3973,4061,7989,45,145,9360.81,0.9,-1.88936,53.2428,8128.0
2540,2011,SK22 1,SK22 1,Total,1127,551,576,1127,0,23,1489.65,0.8,-1.99455,53.3847,950.0
2541,2011,SK22 2,SK22 2,Total,2381,1186,1195,2377,4,40,3114.03,0.8,-1.94889,53.3807,2366.0
2542,2011,SK22 3,SK22 3,Total,3077,1545,1532,3075,2,55,427.83,7.2,-2.0154,53.3677,2930.0
2543,2011,SK22 4,SK22 4,Total,5645,2778,2867,5556,89,58,273.87,20.6,-2.00431,53.3716,5975.0
2544,2011,SK23 0,SK23 0,Total,4579,2243,2336,4566,13,67,1432.25,3.2,-1.91243,53.3253,4656.0
2545,2011,SK23 6,SK23 6,Total,2142,1066,1076,2135,7,44,1251.53,1.7,-1.93721,53.3393,2168.0
2546,2011,SK23 7,SK23 7,Total,7873,3934,3939,7865,8,120,2698.27,2.9,-1.98093,53.3289,7733.0
2547,2011,SK23 9,SK23 9,Total,2531,1216,1315,2427,104,40,1432.62,1.8,-1.92488,53.3189,2623.0
2548,2011,SN10 1,SN10 1,Total,3942,1862,2080,3896,46,57,1214.09,3.2,-2.00622,51.3505,4033.0
2549,2011,SN10 2,SN10 2,Total,6430,3141,3289,6287,143,121,3133.11,2.1,-1.98852,51.3619,6440.0
2550,2011,SN10 3,SN10 3,Total,7604,3681,3923,7587,17,141,8345.01,0.9,-1.95493,51.3451,7493.0
2551,2011,SN10 4,SN10 4,Total,5268,2585,2683,4840,428,148,5833.22,0.9,-1.9777,51.2968,5218.0
2552,2011,SN10 5,SN10 5,Total,8300,4190,4110,7920,380,179,3906.64,2.1,-2.00657,51.3294,8353.0
2553,2011,SN11 0,SN11 0,Total,6041,2816,3225,5704,337,96,2762.59,2.2,-2.00607,51.4317,6088.0
2554,2011,SN11 8,SN11 8,Total,7377,3583,3794,7366,11,92,5701.95,1.3,-1.98356,51.4387,7288.0
2555,2011,SN11 9,SN11 9,Total,8940,4417,4523,8811,129,122,1830.84,4.9,-2.0137,51.4492,9124.0
2556,2011,SN12 6,SN12 6,Total,9714,4820,4894,9694,20,137,1828.3,5.3,-2.1263,51.3622,10063.0
2557,2011,SN12 7,SN12 7,Total,9761,4774,4987,9664,97,114,2071.33,4.7,-2.12807,51.3767,9205.0
2558,2011,SN12 8,SN12 8,Total,5736,2768,2968,5534,202,69,2378.95,2.4,-2.16496,51.3837,5837.0
2559,2011,SN13 0,SN13 0,Total,4756,2291,2465,4679,77,83,716.06,6.6,-2.20168,51.4338,4562.0
2560,2011,SN13 8,SN13 8,Total,2524,1228,1296,2486,38,68,1776.04,1.4,-2.24379,51.4179,2504.0
2561,2011,SN13 9,SN13 9,Total,9249,4442,4807,9155,94,184,2054.72,4.5,-2.19147,51.4261,9423.0
2562,2011,SN14 0,SN14 0,Total,12717,6216,6501,12674,43,192,299.26,42.5,-2.13842,51.4569,12884.0
2563,2011,SN14 6,SN14 6,Total,7400,3731,3669,7101,299,187,7946.16,0.9,-2.15411,51.4995,7052.0
2564,2011,SN14 7,SN14 7,Total,2761,1366,1395,2751,10,77,4864.34,0.6,-2.22078,51.4872,2765.0
2565,2011,SN14 8,SN14 8,Total,5205,2702,2503,4913,292,116,6166.52,0.8,-2.28381,51.4579,5366.0
2566,2011,SN15 1,SN15 1,Total,6720,3307,3413,6649,71,89,249.05,27.0,-2.11921,51.4661,6827.0
2567,2011,SN15 2,SN15 2,Total,5081,2544,2537,4877,204,107,3575.2,1.4,-2.0962,51.4229,5196.0
2568,2011,SN15 3,SN15 3,Total,11587,5785,5802,11461,126,236,1788.02,6.5,-2.10698,51.4544,11511.0
2569,2011,SN15 4,SN15 4,Total,8219,4228,3991,7637,582,179,7031.67,1.2,-2.02213,51.5073,7985.0
2570,2011,SN15 5,SN15 5,Total,3502,1723,1779,3460,42,92,4914.29,0.7,-2.06041,51.5251,3645.0
2571,2011,SN16 0,SN16 0,Total,5989,2917,3072,5886,103,124,6175.82,1.0,-2.1317,51.5776,6118.0
2572,2011,SN16 9,SN16 9,Total,7842,3936,3906,7823,19,238,9203.61,0.9,-2.05587,51.6,7599.0
2573,2011,SN25 1,SN25 1,Total,9952,4993,4959,9919,33,93,262.89,37.9,-1.81339,51.5919,9619.0
2574,2011,SN25 2,SN25 2,Total,9693,4891,4802,9693,0,59,221.91,43.7,-1.81859,51.6048,9847.0
2575,2011,SN25 3,SN25 3,Total,7562,3685,3877,7542,20,43,190.31,39.7,-1.79714,51.5849,7484.0
2576,2011,SN25 4,SN25 4,Total,7998,3982,4016,7998,0,78,228.13,35.1,-1.78484,51.5923,8077.0
2577,2011,SN26 7,SN26 7,Total,1537,750,787,1492,45,18,651.9,2.4,-1.77915,51.6102,1493.0
2578,2011,SN26 8,SN26 8,Total,290,150,140,290,0,7,866.46,0.3,-1.79815,51.6139,270.0
2579,2011,SO14 0,SO14 0,Total,7763,4337,3426,7397,366,60,93.51,83.0,-1.39364,50.9133,8116.0
2580,2011,SO14 1,SO14 1,Total,3463,1893,1570,2728,735,45,50.86,68.1,-1.39676,50.9058,3183.0
2581,2011,SO14 2,SO14 2,Total,1150,622,528,1150,0,10,65.59,17.5,-1.40267,50.902,1246.0
2582,2011,SO14 3,SO14 3,Total,6332,3549,2783,4834,1498,81,133.34,47.5,-1.39572,50.9009,6674.0
2583,2011,SO14 5,SO14 5,Total,2508,1277,1231,2508,0,6,61.59,40.7,-1.38845,50.9072,2224.0
2584,2011,SO14 6,SO14 6,Total,5988,3203,2785,5920,68,36,55.84,107.2,-1.39836,50.9183,5606.0
2585,2011,SO14 7,SO14 7,Total,247,166,81,164,83,2,36.97,6.7,-1.40326,50.908,184.0
2586,2011,SO15 0,SO15 0,Total,1233,678,555,1233,0,2,23.07,53.4,-1.45329,50.9166,1304.0
2587,2011,SO15 1,SO15 1,Total,1618,858,760,1596,22,2,137.04,11.8,-1.42103,50.909,1790.0
2588,2011,SO15 2,SO15 2,Total,10023,5313,4710,9277,746,110,109.95,91.2,-1.41156,50.9147,9888.0
2589,2011,SO15 3,SO15 3,Total,6986,3587,3399,6986,0,38,84.48,82.7,-1.4278,50.9152,6983.0
2590,2011,SO15 4,SO15 4,Total,3154,1533,1621,3154,0,27,79.3,39.8,-1.44352,50.9177,3346.0
2591,2011,SO15 5,SO15 5,Total,12549,6354,6195,12360,189,155,223.17,56.2,-1.42498,50.92,12245.0
2592,2011,SO15 7,SO15 7,Total,2930,1427,1503,2930,0,65,113.3,25.9,-1.42111,50.9258,3000.0
2593,2011,SO15 8,SO15 8,Total,3619,1790,1829,3548,71,19,174.74,20.7,-1.43501,50.9176,3198.0
2594,2011,SO16 0,SO16 0,Total,1529,733,796,1529,0,21,549.23,2.8,-1.4679,50.9412,1729.0
2595,2011,SO16 2,SO16 2,Total,821,425,396,821,0,10,30.2,27.2,-1.38672,50.9376,1046.0
2596,2011,SO16 3,SO16 3,Total,11168,5729,5439,9128,2040,128,205.83,54.3,-1.39844,50.9391,10967.0
2597,2011,SO16 4,SO16 4,Total,7223,3446,3777,7163,60,36,102.35,70.6,-1.44435,50.9235,7703.0
2598,2011,SO16 5,SO16 5,Total,7542,3691,3851,7542,0,50,122.86,61.4,-1.43821,50.9354,7328.0
2599,2011,SO16 6,SO16 6,Total,7301,3625,3676,7264,37,50,174.86,41.8,-1.43134,50.9304,7526.0
2600,2011,SO16 7,SO16 7,Total,6206,3112,3094,6082,124,140,1297.21,4.8,-1.41351,50.9406,6295.0
2601,2011,SO16 8,SO16 8,Total,12358,6058,6300,12323,35,122,806.46,15.3,-1.44632,50.9419,12163.0
2602,2011,SO16 9,SO16 9,Total,11770,5643,6127,11770,0,49,361.91,32.5,-1.45724,50.9274,11593.0
2603,2011,SO17 1,SO17 1,Total,6840,3486,3354,6594,246,121,158.6,43.1,-1.40216,50.926,6840.0
2604,2011,SO17 2,SO17 2,Total,7729,4024,3705,7613,116,39,96.28,80.3,-1.39278,50.9236,7656.0
2605,2011,SO17 3,SO17 3,Total,4753,2605,2148,4753,0,46,63.59,74.7,-1.39398,50.9315,4935.0
2606,2011,SO18 1,SO18 1,Total,8209,4212,3997,8149,60,81,167.35,49.1,-1.37605,50.9221,8307.0
2607,2011,SO18 2,SO18 2,Total,10462,5173,5289,8868,1594,78,266.84,39.2,-1.36583,50.9362,10611.0
2608,2011,SO18 3,SO18 3,Total,4203,2060,2143,4203,0,48,89.09,47.2,-1.34557,50.9289,4108.0
2609,2011,SO18 4,SO18 4,Total,4138,1969,2169,4111,27,45,77.22,53.6,-1.36764,50.9207,4170.0
2610,2011,SO18 5,SO18 5,Total,7714,3751,3963,7675,39,57,154.32,50.0,-1.34631,50.9186,7598.0
2611,2011,SO18 6,SO18 6,Total,2264,1079,1185,2264,0,15,44.9,50.4,-1.35651,50.9182,2284.0
2612,2011,SO19 0,SO19 0,Total,3784,1803,1981,3784,0,30,79.67,47.5,-1.34115,50.9,3863.0
2613,2011,SO19 1,SO19 1,Total,2947,1433,1514,2947,0,13,53.23,55.4,-1.34568,50.9001,2758.0
2614,2011,SO19 2,SO19 2,Total,6233,3088,3145,6198,35,22,95.3,65.4,-1.36904,50.9031,6806.0
2615,2011,SO19 4,SO19 4,Total,1969,1002,967,1967,2,28,44.11,44.6,-1.36911,50.9142,1630.0
2616,2011,SO19 5,SO19 5,Total,1560,775,785,1560,0,12,39.63,39.4,-1.34791,50.9126,1632.0
2617,2011,SO19 6,SO19 6,Total,9244,4450,4794,9218,26,26,184.62,50.1,-1.33475,50.9082,8801.0
2618,2011,SO19 7,SO19 7,Total,7433,3669,3764,7387,46,45,160.16,46.4,-1.36996,50.9085,7114.0
2619,2011,SO19 8,SO19 8,Total,8190,4065,4125,8166,24,55,151.68,54.0,-1.35431,50.9044,8289.0
2620,2011,SO19 9,SO19 9,Total,14982,7275,7707,14780,202,62,319.28,46.9,-1.37061,50.8935,15106.0
2621,2011,SO20 6,SO20 6,Total,4346,2124,2222,4330,16,150,9935.63,0.4,-1.45789,51.1026,4440.0
2622,2011,SO20 8,SO20 8,Total,3735,1923,1812,3510,225,132,4864.04,0.8,-1.55349,51.1292,3679.0
2623,2011,SO21 1,SO21 1,Total,7285,3530,3755,7250,35,199,8354.93,0.9,-1.29135,51.0341,7543.0
2624,2011,SO21 2,SO21 2,Total,6172,3114,3058,5746,426,240,7853.29,0.8,-1.35068,51.0459,6062.0
2625,2011,SO21 3,SO21 3,Total,6100,2987,3113,6073,27,169,10355.1,0.6,-1.31252,51.1442,6157.0
2626,2011,SO22 4,SO22 4,Total,11717,5485,6232,11186,531,230,382.73,30.6,-1.33271,51.054,10979.0
2627,2011,SO22 5,SO22 5,Total,7831,3842,3989,6679,1152,242,337.86,23.2,-1.33345,51.0653,8350.0
2628,2011,SO22 6,SO22 6,Total,9063,4357,4706,8750,313,235,669.09,13.5,-1.32938,51.0776,9217.0
2629,2011,SO23 0,SO23 0,Total,5490,2521,2969,5233,257,83,297.88,18.4,-1.30123,51.0626,5383.0
2630,2011,SO23 7,SO23 7,Total,9186,4314,4872,8552,634,199,1838.05,5.0,-1.3063,51.0805,8823.0
2631,2011,SO23 8,SO23 8,Total,2740,1322,1418,2641,99,20,58.06,47.2,-1.30866,51.0635,3011.0
2632,2011,SO23 9,SO23 9,Total,4948,2740,2208,4140,808,209,316.25,15.6,-1.3124,51.0587,4889.0
2633,2011,SO24 0,SO24 0,Total,4264,2096,2168,4167,97,167,10557.29,0.4,-1.1355,51.0698,4197.0
2634,2011,SO24 9,SO24 9,Total,7060,3383,3677,7026,34,221,7267.98,1.0,-1.16,51.0963,7220.0
2635,2011,SO30 0,SO30 0,Total,6658,3234,3424,6590,68,54,154.05,43.2,-1.30172,50.9115,6727.0
2636,2011,SO30 2,SO30 2,Total,13627,6610,7017,13464,163,150,1552.48,8.8,-1.2949,50.9228,13305.0
2637,2011,SO30 3,SO30 3,Total,6124,2979,3145,6032,92,81,1000.58,6.1,-1.32967,50.9282,6428.0
2638,2011,SO30 4,SO30 4,Total,5869,2834,3035,5726,143,63,311.44,18.8,-1.3069,50.9168,5891.0
2639,2011,SO31 1,SO31 1,Total,1743,875,868,1743,0,19,204.94,8.5,-1.27538,50.8808,2127.0
2640,2011,SO31 4,SO31 4,Total,4695,2375,2320,4695,0,38,335.23,14.0,-1.31219,50.8638,4710.0
2641,2011,SO31 5,SO31 5,Total,6338,3068,3270,6248,90,51,549.93,11.5,-1.33679,50.8754,6303.0
2642,2011,SO31 6,SO31 6,Total,11326,5536,5790,11266,60,183,263.81,42.9,-1.27317,50.8641,11298.0
2643,2011,SO31 7,SO31 7,Total,6846,3319,3527,6625,221,128,667.11,10.3,-1.2816,50.8727,6777.0
2644,2011,SO31 8,SO31 8,Total,6955,3371,3584,6928,27,70,673.21,10.3,-1.31054,50.8857,6613.0
2645,2011,SO31 9,SO31 9,Total,6830,3462,3368,6604,226,118,850.04,8.0,-1.28698,50.8568,6914.0
2646,2011,SO32 1,SO32 1,Total,7386,3518,3868,7321,65,150,3211.82,2.3,-1.22326,50.9567,7448.0
2647,2011,SO32 2,SO32 2,Total,9502,4644,4858,9384,118,249,3833.6,2.5,-1.22622,50.9335,9706.0
2648,2011,SO32 3,SO32 3,Total,2864,1390,1474,2845,19,114,6285.57,0.5,-1.15607,50.9571,2717.0
2649,2011,SO40 2,SO40 2,Total,9306,4552,4754,8997,309,95,2540.46,3.7,-1.5295,50.927,8983.0
2650,2011,SO40 3,SO40 3,Total,7229,3580,3649,7167,62,57,279.96,25.8,-1.49771,50.9246,7570.0
2651,2011,SO40 4,SO40 4,Total,6141,3076,3065,6022,119,82,814.54,7.5,-1.45707,50.8965,6333.0
2652,2011,SO40 7,SO40 7,Total,5375,2633,2742,5243,132,69,996.37,5.4,-1.52058,50.9074,5299.0
2653,2011,SO40 8,SO40 8,Total,8227,4081,4146,8221,6,87,191.39,43.0,-1.51057,50.92,8281.0
2654,2011,SO40 9,SO40 9,Total,5577,2676,2901,5541,36,58,431.68,12.9,-1.49146,50.9138,5464.0
2655,2011,SO41 0,SO41 0,Total,9898,4635,5263,9804,94,115,1774.53,5.6,-1.59302,50.7399,9928.0
2656,2011,SO41 3,SO41 3,Total,2730,1259,1471,2694,36,48,125.77,21.7,-1.5402,50.7548,2723.0
2657,2011,SO41 5,SO41 5,Total,1421,732,689,1358,63,40,1801.45,0.8,-1.52033,50.7716,1582.0
2658,2011,SO41 6,SO41 6,Total,3644,1715,1929,3507,137,84,1427.89,2.6,-1.59594,50.7771,3597.0
2659,2011,SO41 8,SO41 8,Total,7110,3384,3726,6970,140,117,1836.34,3.9,-1.55696,50.7586,7133.0
2660,2011,SO41 9,SO41 9,Total,6585,3035,3550,6556,29,70,257.58,25.6,-1.545,50.7591,6375.0
2661,2011,SO42 7,SO42 7,Total,5273,2566,2707,5062,211,121,16626.78,0.3,-1.53853,50.8061,4978.0
2662,2011,SO43 7,SO43 7,Total,4391,2128,2263,4191,200,78,8399.07,0.5,-1.58222,50.8891,4419.0
2663,2011,SO45 1,SO45 1,Total,7879,3847,4032,7826,53,81,3415.19,2.3,-1.36819,50.8232,7751.0
2664,2011,SO45 2,SO45 2,Total,6582,3186,3396,6582,0,39,319.83,20.6,-1.38805,50.8357,6705.0
2665,2011,SO45 3,SO45 3,Total,4736,2281,2455,4700,36,35,168.53,28.1,-1.39639,50.8539,4822.0
2666,2011,SO45 4,SO45 4,Total,5362,2657,2705,5324,38,88,150.29,35.7,-1.40943,50.8567,5020.0
2667,2011,SO45 5,SO45 5,Total,6965,3352,3613,6963,2,65,727.79,9.6,-1.41262,50.8648,7352.0
2668,2011,SO45 6,SO45 6,Total,3463,1647,1816,3458,5,16,211.05,16.4,-1.39894,50.8677,3346.0
2669,2011,SO50 4,SO50 4,Total,9080,4560,4520,9066,14,98,341.48,26.6,-1.35588,50.9803,9203.0
2670,2011,SO50 5,SO50 5,Total,10176,5055,5121,10154,22,43,727.03,14.0,-1.359,50.9654,10156.0
2671,2011,SO50 6,SO50 6,Total,6202,3046,3156,6169,33,61,611.13,10.1,-1.3357,50.9741,6202.0
2672,2011,SO50 7,SO50 7,Total,8008,4046,3962,7960,48,105,1100.56,7.3,-1.30278,50.9631,7900.0
2673,2011,SO50 8,SO50 8,Total,6741,3333,3408,6735,6,66,309.44,21.8,-1.31728,50.9668,6932.0
2674,2011,SO50 9,SO50 9,Total,6183,3076,3107,6112,71,35,187.32,33.0,-1.36486,50.9694,6051.0
2675,2011,SO51 0,SO51 0,Total,4169,2096,2073,3972,197,126,6389.59,0.7,-1.50794,51.0159,4507.0
2676,2011,SO51 5,SO51 5,Total,4093,1963,2130,4072,21,68,527.8,7.8,-1.48027,50.9882,4142.0
2677,2011,SO51 6,SO51 6,Total,4535,2215,2320,4336,199,103,3788.25,1.2,-1.56038,50.9808,4794.0
2678,2011,SO51 7,SO51 7,Total,8272,3958,4314,8128,144,153,656.62,12.6,-1.48407,50.9956,7602.0
2679,2011,SO51 8,SO51 8,Total,4633,2114,2519,4569,64,59,179.06,25.9,-1.49204,50.9894,4819.0
2680,2011,SO51 9,SO51 9,Total,876,434,442,870,6,30,1181.63,0.7,-1.46437,50.99,1299.0
2681,2011,SO52 9,SO52 9,Total,7037,3416,3621,6987,50,66,810.75,8.7,-1.43623,50.9776,6973.0
2682,2011,SO53 1,SO53 1,Total,5232,2523,2709,5101,131,133,182.83,28.6,-1.383,50.9918,5261.0
2683,2011,SO53 2,SO53 2,Total,8335,4019,4316,8276,59,78,202.6,41.1,-1.37391,50.9844,8431.0
2684,2011,SO53 3,SO53 3,Total,6437,3090,3347,6423,14,73,206.24,31.2,-1.381,50.9739,6273.0
2685,2011,SO53 4,SO53 4,Total,7462,3690,3772,7462,0,183,261.94,28.5,-1.39074,50.9811,7749.0
2686,2011,SO53 5,SO53 5,Total,4993,2452,2541,4987,6,121,218.39,22.9,-1.37775,50.9967,4758.0
2687,2011,SP10 1,SP10 1,Total,3889,1849,2040,3853,36,23,209.18,18.6,-1.47527,51.2105,3994.0
2688,2011,SP10 2,SP10 2,Total,9767,4777,4990,9672,95,128,451.04,21.7,-1.47981,51.2038,9985.0
2689,2011,SP10 3,SP10 3,Total,14110,6886,7224,13782,328,174,727.1,19.4,-1.49725,51.2098,13590.0
2690,2011,SP10 4,SP10 4,Total,6845,3392,3453,6823,22,79,326.45,21.0,-1.48988,51.22,7049.0
2691,2011,SP10 5,SP10 5,Total,6041,2947,3094,6041,0,47,164.57,36.7,-1.46899,51.218,5890.0
2692,2011,SP11 0,SP11 0,Total,3439,1676,1763,3379,60,136,8747.73,0.4,-1.4891,51.2633,3462.0
2693,2011,SP11 6,SP11 6,Total,4351,2162,2189,4230,121,73,5417.68,0.8,-1.43706,51.2258,4412.0
2694,2011,SP11 7,SP11 7,Total,4452,2155,2297,4350,102,150,6039.34,0.7,-1.5026,51.1843,4711.0
2695,2011,SP11 8,SP11 8,Total,4080,2043,2037,3954,126,140,5747.5,0.7,-1.56857,51.2011,3625.0
2696,2011,SP11 9,SP11 9,Total,7124,3709,3415,6574,550,111,5562.32,1.3,-1.59502,51.2504,7171.0
2697,2011,SS11 7,SS11 7,Total,7001,3398,3603,6789,212,42,1365.7,5.1,0.531788,51.6236,7084.0
2698,2011,SS11 8,SS11 8,Total,9737,4782,4955,9683,54,92,1385.87,7.0,0.540329,51.6112,9720.0
2699,2011,SS12 0,SS12 0,Total,6959,3367,3592,6909,50,42,605.09,11.5,0.51248,51.6086,7179.0
2700,2011,SS12 9,SS12 9,Total,11070,5430,5640,11004,66,100,792.37,14.0,0.527537,51.6037,10890.0
2701,2011,SS13 1,SS13 1,Total,9231,4522,4709,9168,63,58,336.09,27.5,0.507555,51.5818,8952.0
2702,2011,SS13 2,SS13 2,Total,5396,2639,2757,5327,69,36,831.09,6.5,0.517728,51.5712,5548.0
2703,2011,SS13 3,SS13 3,Total,7497,3661,3836,7497,0,39,637.6,11.8,0.499916,51.5691,7557.0
2704,2011,SS14 1,SS14 1,Total,9518,4597,4921,9476,42,57,189.94,50.1,0.471291,51.5702,9786.0
2705,2011,SS14 2,SS14 2,Total,11007,5067,5940,10694,313,52,561.92,19.6,0.469713,51.5765,10944.0
2706,2011,SS14 3,SS14 3,Total,4390,2119,2271,4390,0,31,123.21,35.6,0.481198,51.5822,4465.0
2707,2011,SS15 4,SS15 4,Total,5443,2662,2781,5418,25,56,468.34,11.6,0.437641,51.5861,5181.0
2708,2011,SS15 5,SS15 5,Total,16186,7712,8474,16085,101,94,302.84,53.4,0.435335,51.5742,16817.0
2709,2011,SS15 6,SS15 6,Total,8634,4180,4454,8620,14,57,467.66,18.5,0.416851,51.5762,7970.0
2710,2011,SS16 4,SS16 4,Total,11825,5812,6013,11780,45,71,482.6,24.5,0.482633,51.5621,11630.0
2711,2011,SS16 5,SS16 5,Total,9879,4841,5038,9853,26,94,559.6,17.7,0.451314,51.563,9560.0
2712,2011,SS16 6,SS16 6,Total,7786,3815,3971,7694,92,99,281.46,27.7,0.415559,51.5642,8385.0
2713,2011,SS17 0,SS17 0,Total,8181,4058,4123,8140,41,94,971.7,8.4,0.424364,51.5103,8068.0
2714,2011,SS17 7,SS17 7,Total,11475,5461,6014,11423,52,81,254.38,45.1,0.445567,51.5246,11354.0
2715,2011,SS17 8,SS17 8,Total,9021,4445,4576,9018,3,98,1178.74,7.7,0.42761,51.5267,9050.0
2716,2011,SS17 9,SS17 9,Total,4146,2039,2107,4141,5,47,2087.9,2.0,0.468004,51.5284,4046.0
2717,2011,ST10 1,ST10 1,Total,11283,5561,5722,11138,145,124,1477.86,7.6,-1.98664,52.984,11200.0
2718,2011,ST10 2,ST10 2,Total,5191,2602,2589,5095,96,73,6255.14,0.8,-1.98553,53.0183,4958.0
2719,2011,ST10 3,ST10 3,Total,2223,1140,1083,2213,10,30,5028.2,0.4,-1.89329,53.0264,2064.0
2720,2011,ST10 4,ST10 4,Total,6901,3453,3448,6859,42,106,6052.3,1.1,-1.95474,52.953,7177.0
2721,2011,ST11 9,ST11 9,Total,9995,4939,5056,9875,120,122,3784.76,2.6,-2.06776,52.9669,9827.0
2722,2011,ST12 9,ST12 9,Total,3809,1841,1968,3702,107,39,2224.37,1.7,-2.17227,52.9538,3597.0
2723,2011,ST13 5,ST13 5,Total,6307,3059,3248,6186,121,64,641.38,9.8,-2.02368,53.1026,6564.0
2724,2011,ST13 6,ST13 6,Total,6208,3006,3202,6121,87,62,244.2,25.4,-2.01624,53.1091,6047.0
2725,2011,ST13 7,ST13 7,Total,6781,3388,3393,6700,81,79,7654.93,0.9,-1.99163,53.0783,7168.0
2726,2011,ST13 8,ST13 8,Total,8685,4217,4468,8535,150,114,6363.23,1.4,-2.04156,53.1138,8368.0
2727,2011,ST14 5,ST14 5,Total,4748,2368,2380,4505,243,88,4249.62,1.1,-1.87148,52.9343,5075.0
2728,2011,ST14 7,ST14 7,Total,8383,4124,4259,8314,69,81,483.99,17.3,-1.87454,52.9028,8558.0
2729,2011,ST14 8,ST14 8,Total,7414,4112,3302,6418,996,129,5182.21,1.4,-1.86414,52.8864,7156.0
2730,2011,ST15 0,ST15 0,Total,8964,4424,4540,8816,148,138,4979.6,1.8,-2.1687,52.8946,8763.0
2731,2011,ST15 8,ST15 8,Total,12448,6018,6430,12260,188,190,3281.05,3.8,-2.13547,52.9051,12550.0
2732,2011,ST16 1,ST16 1,Total,12949,6288,6661,12780,169,154,667.7,19.4,-2.13368,52.8172,12893.0
2733,2011,ST16 2,ST16 2,Total,1716,891,825,1700,16,6,128.28,13.4,-2.12027,52.8078,1814.0
2734,2011,ST16 3,ST16 3,Total,16290,9078,7212,15371,919,189,536.76,30.3,-2.10792,52.813,16084.0
2735,2011,ST17 0,ST17 0,Total,12204,5957,6247,12109,95,235,6305.99,1.9,-2.07142,52.7858,11829.0
2736,2011,ST17 4,ST17 4,Total,12322,6128,6194,12262,60,145,570.59,21.6,-2.103,52.7934,12168.0
2737,2011,ST17 9,ST17 9,Total,15192,7406,7786,15119,73,150,399.75,38.0,-2.1254,52.7895,15363.0
2738,2011,ST18 0,ST18 0,Total,10721,5570,5151,9764,957,208,10848.4,1.0,-2.03121,52.8243,10887.0
2739,2011,ST18 9,ST18 9,Total,5502,2777,2725,5312,190,84,8698.51,0.6,-2.16564,52.7998,5724.0
2740,2011,ST19 5,ST19 5,Total,8526,4181,4345,8505,21,103,4173.72,2.0,-2.11112,52.7228,8698.0
2741,2011,ST19 9,ST19 9,Total,6225,2996,3229,6178,47,102,5755.94,1.1,-2.18524,52.7083,6152.0
2742,2011,ST20 0,ST20 0,Total,6711,3323,3388,6698,13,151,8153.65,0.8,-2.25484,52.7986,6677.0
2743,2011,ST21 6,ST21 6,Total,5674,2690,2984,5404,270,121,9772.67,0.6,-2.26253,52.8687,6045.0
2744,2011,SW10 0,SW10 0,Total,9055,4336,4719,9045,10,168,64.32,140.8,-0.181651,51.4817,8938.0
2745,2011,SW10 9,SW10 9,Total,9423,4642,4781,9315,108,181,67.83,138.9,-0.184356,51.4858,9572.0
2746,2011,SW11 1,SW11 1,Total,9502,4656,4846,9478,24,56,107.95,88.0,-0.167297,51.4625,9197.0
2747,2011,SW11 2,SW11 2,Total,13912,6612,7300,13880,32,97,98.29,141.5,-0.170697,51.4657,13204.0
2748,2011,SW11 3,SW11 3,Total,11688,5786,5902,11620,68,121,75.31,155.2,-0.171519,51.4702,12474.0
2749,2011,SW11 4,SW11 4,Total,8147,3990,4157,7981,166,150,107.14,76.0,-0.161316,51.474,8041.0
2750,2011,SW11 5,SW11 5,Total,17165,8247,8918,17165,0,176,116.2,147.7,-0.158764,51.4672,16825.0
2751,2011,SW11 6,SW11 6,Total,11303,5571,5732,11265,38,262,95.64,118.2,-0.163126,51.4578,10860.0
2752,2011,SW12 0,SW12 0,Total,7826,3713,4113,7813,13,76,72.82,107.5,-0.142503,51.4459,8236.0
2753,2011,SW12 8,SW12 8,Total,12832,6218,6614,12618,214,317,119.77,107.1,-0.155717,51.4473,12838.0
2754,2011,SW12 9,SW12 9,Total,10928,5331,5597,10872,56,84,109.66,99.7,-0.149161,51.4452,10316.0
2755,2011,SW13 0,SW13 0,Total,6917,3304,3613,6873,44,165,133.62,51.8,-0.251997,51.4699,6658.0
2756,2011,SW13 8,SW13 8,Total,1917,952,965,1917,0,52,43.67,43.9,-0.238471,51.4807,1783.0
2757,2011,SW13 9,SW13 9,Total,7356,3540,3816,7305,51,216,212.5,34.6,-0.246626,51.4778,7432.0
2758,2011,SW14 7,SW14 7,Total,7593,3681,3912,7587,6,178,150.89,50.3,-0.271011,51.4658,7502.0
2759,2011,SW14 8,SW14 8,Total,9237,4434,4803,9087,150,212,507.62,18.2,-0.26316,51.4666,9216.0
2760,2011,SW15 1,SW15 1,Total,10044,4779,5265,10034,10,229,108.35,92.7,-0.220423,51.4645,9574.0
2761,2011,SW15 2,SW15 2,Total,10338,4882,5456,10260,78,118,102.34,101.0,-0.212892,51.4596,10292.0
2762,2011,SW15 3,SW15 3,Total,11536,5492,6044,11211,325,181,268.45,43.0,-0.22986,51.4501,11142.0
2763,2011,SW15 4,SW15 4,Total,10338,4749,5589,9747,591,100,199.23,51.9,-0.240053,51.4504,10104.0
2764,2011,SW15 5,SW15 5,Total,9901,4478,5423,8864,1037,220,206.93,47.8,-0.23892,51.4591,10245.0
2765,2011,SW15 6,SW15 6,Total,8299,4030,4269,8278,21,225,98.04,84.6,-0.224431,51.46,9308.0
2766,2011,SW16 1,SW16 1,Total,10750,5291,5459,10565,185,112,125.18,85.9,-0.133266,51.4321,10776.0
2767,2011,SW16 2,SW16 2,Total,16493,8041,8452,16155,338,162,167.29,98.6,-0.124079,51.4307,16055.0
2768,2011,SW16 3,SW16 3,Total,8864,4442,4422,8758,106,168,198.42,44.7,-0.120337,51.4205,9285.0
2769,2011,SW16 4,SW16 4,Total,13469,6521,6948,13369,100,211,158.06,85.2,-0.125727,51.4116,13406.0
2770,2011,SW16 5,SW16 5,Total,17193,8444,8749,17091,102,186,169.47,101.5,-0.134018,51.4181,17402.0
2771,2011,SW16 6,SW16 6,Total,14158,6929,7229,13847,311,185,116.18,121.9,-0.138102,51.4252,14636.0
2772,2011,SW17 0,SW17 0,Total,14832,7067,7765,14390,442,128,188.51,78.7,-0.175081,51.4304,14916.0
2773,2011,SW17 6,SW17 6,Total,1806,917,889,1786,20,9,43.77,41.3,-0.153744,51.4296,1682.0
2774,2011,SW17 7,SW17 7,Total,12324,6058,6266,12027,297,202,119.74,102.9,-0.163697,51.4358,12844.0
2775,2011,SW17 8,SW17 8,Total,19501,9309,10192,19408,93,263,146.73,132.9,-0.16004,51.4311,18906.0
2776,2011,SW17 9,SW17 9,Total,15752,7813,7939,15693,59,135,120.95,130.2,-0.16261,51.4244,16218.0
2777,2011,SW18 1,SW18 1,Total,10734,5488,5246,10715,19,144,136.18,78.8,-0.193888,51.4575,10563.0
2778,2011,SW18 2,SW18 2,Total,9817,4769,5048,9778,39,174,107.34,91.5,-0.185928,51.4534,10288.0
2779,2011,SW18 3,SW18 3,Total,14557,7618,6939,13310,1247,286,196.71,74.0,-0.183013,51.446,14596.0
2780,2011,SW18 4,SW18 4,Total,10453,5033,5420,10427,26,48,102.48,102.0,-0.192765,51.4488,10566.0
2781,2011,SW18 5,SW18 5,Total,13431,6486,6945,13431,0,209,131.79,101.9,-0.200649,51.4467,13825.0
2782,2011,SW19 1,SW19 1,Total,10393,5188,5205,10294,99,58,95.12,109.3,-0.196815,51.4182,10288.0
2783,2011,SW19 2,SW19 2,Total,12147,6112,6035,11916,231,82,147.58,82.3,-0.186269,51.4159,12110.0
2784,2011,SW19 3,SW19 3,Total,10792,5384,5408,10792,0,201,209.55,51.5,-0.2035,51.4131,11172.0
2785,2011,SW19 4,SW19 4,Total,6463,3180,3283,6345,118,191,426.39,15.2,-0.216613,51.4197,6715.0
2786,2011,SW19 5,SW19 5,Total,3987,1935,2052,3898,89,171,140.68,28.3,-0.217845,51.4298,4310.0
2787,2011,SW19 6,SW19 6,Total,12029,5671,6358,11875,154,126,119.12,101.0,-0.215397,51.4381,11803.0
2788,2011,SW19 7,SW19 7,Total,6379,3158,3221,6352,27,227,144.83,44.0,-0.208082,51.4245,6423.0
2789,2011,SW19 8,SW19 8,Total,15486,7595,7891,15304,182,202,237.54,65.2,-0.199999,51.425,14632.0
2790,2011,SW1A 1,SW1A 1,Total,246,150,96,245,1,3,20.93,11.8,-0.138945,51.5026,225.0
2791,2011,SW1E 5,SW1E 5,Total,258,132,126,191,67,2,5.74,44.9,-0.141127,51.4967,258.0
2792,2011,SW1E 6,SW1E 6,Total,661,437,224,398,263,17,30.29,21.8,-0.139104,51.497,684.0
2793,2011,SW1H 0,SW1H 0,Total,388,211,177,388,0,7,19.15,20.3,-0.135055,51.4971,378.0
2794,2011,SW1H 9,SW1H 9,Total,346,197,149,346,0,7,15.05,23.0,-0.133781,51.4984,316.0
2795,2011,SW1P 1,SW1P 1,Total,2590,1354,1236,2341,249,55,18.95,136.7,-0.13633,51.4868,2571.0
2796,2011,SW1P 2,SW1P 2,Total,3526,1859,1667,3338,188,43,19.53,180.5,-0.133665,51.4938,3382.0
2797,2011,SW1P 3,SW1P 3,Total,855,537,318,649,206,39,37.56,22.8,-0.130233,51.4955,982.0
2798,2011,SW1P 4,SW1P 4,Total,6537,3302,3235,6481,56,75,37.26,175.4,-0.131248,51.4918,6033.0
2799,2011,SW1V 1,SW1V 1,Total,2144,1077,1067,2032,112,28,18.25,117.5,-0.141048,51.4933,2332.0
2800,2011,SW1V 2,SW1V 2,Total,5743,2876,2867,5731,12,82,23.5,244.4,-0.136982,51.4913,6151.0
2801,2011,SW1V 3,SW1V 3,Total,8580,4183,4397,8535,45,99,36.61,234.4,-0.137569,51.4881,8592.0
2802,2011,SW1V 4,SW1V 4,Total,6107,3045,3062,6106,1,101,23.08,264.6,-0.142734,51.4902,6078.0
2803,2011,SW1W 0,SW1W 0,Total,695,373,322,611,84,16,31.06,22.4,-0.144585,51.4954,732.0
2804,2011,SW1W 8,SW1W 8,Total,5565,2763,2802,5561,4,133,39.82,139.8,-0.150452,51.4912,5105.0
2805,2011,SW1W 9,SW1W 9,Total,2297,1140,1157,2297,0,129,29.08,79.0,-0.147221,51.4936,2286.0
2806,2011,SW1X 0,SW1X 0,Total,1894,984,910,1894,0,43,14.82,127.8,-0.157438,51.4963,1951.0
2807,2011,SW1X 7,SW1X 7,Total,998,505,493,998,0,40,32.38,30.8,-0.151742,51.4993,839.0
2808,2011,SW1X 8,SW1X 8,Total,1447,735,712,1447,0,31,20.1,72.0,-0.151258,51.497,1851.0
2809,2011,SW1X 9,SW1X 9,Total,1687,898,789,1687,0,31,19.13,88.2,-0.155308,51.4966,1864.0
2810,2011,SW1Y 4,SW1Y 4,Total,299,177,122,299,0,2,25.02,12.0,-0.134169,51.5057,207.0
2811,2011,SW1Y 6,SW1Y 6,Total,251,148,103,243,8,3,11.55,21.7,-0.137327,51.5052,287.0
2812,2011,SW20 0,SW20 0,Total,9083,4413,4670,9039,44,227,242.84,37.4,-0.232476,51.4141,8949.0
2813,2011,SW20 8,SW20 8,Total,10556,5113,5443,10416,140,161,125.21,84.3,-0.220276,51.4134,10870.0
2814,2011,SW20 9,SW20 9,Total,8636,4243,4393,8554,82,166,218.15,39.6,-0.220295,51.4057,8604.0
2815,2011,SY10 0,SY10 0,Total,2231,1147,1084,2212,19,39,23748.83,0.1,-3.33815,52.8128,2240.0
2816,2011,SY10 7,SY10 7,Total,4078,1941,2137,3830,248,63,8254.84,0.5,-3.0792,52.8921,4820.0
2817,2011,SY10 8,SY10 8,Total,3527,1757,1770,3525,2,50,6804.04,0.5,-3.02871,52.802,3452.0
2818,2011,SY10 9,SY10 9,Total,4827,2389,2438,4752,75,85,6438.24,0.7,-3.09772,52.8262,4806.0
2819,2011,SY11 1,SY11 1,Total,6031,2969,3062,5997,34,65,384.87,15.7,-3.05354,52.8598,6337.0
2820,2011,SY11 2,SY11 2,Total,10751,5156,5595,10504,247,121,456.93,23.5,-3.04467,52.8553,10569.0
2821,2011,SY11 3,SY11 3,Total,5779,2831,2948,5411,368,62,1768.18,3.3,-3.0185,52.9121,5416.0
2822,2011,SY11 4,SY11 4,Total,4453,2192,2261,4404,49,65,6302.98,0.7,-2.99262,52.8532,4394.0
2823,2011,SY12 0,SY12 0,Total,4437,2187,2250,4401,36,73,5215.38,0.9,-2.87577,52.9005,4510.0
2824,2011,SY12 9,SY12 9,Total,3813,1909,1904,3560,253,80,7625.68,0.5,-2.92242,52.9049,3491.0
2825,2011,SY13 1,SY13 1,Total,9710,4783,4927,9557,153,102,1880.68,5.2,-2.68451,52.968,9300.0
2826,2011,SY13 2,SY13 2,Total,4062,2020,2042,4029,33,78,5726.36,0.7,-2.69739,52.9149,4218.0
2827,2011,SY13 3,SY13 3,Total,3027,1502,1525,2988,39,51,7147.98,0.4,-2.74519,52.9498,2701.0
2828,2011,SY13 4,SY13 4,Total,2750,1395,1355,2747,3,50,9726.81,0.3,-2.64383,52.9755,3001.0
2829,2011,SY14 7,SY14 7,Total,2424,1190,1234,2422,2,65,6115.77,0.4,-2.79747,53.0185,2661.0
2830,2011,SY14 8,SY14 8,Total,3220,1570,1650,3162,58,74,5028.68,0.6,-2.73533,53.0356,3182.0
2831,2011,SY15 6,SY15 6,Total,5199,2571,2628,5145,54,91,14214.88,0.4,-3.13437,52.5603,5408.0
2832,2011,SY16 1,SY16 1,Total,6685,3229,3456,6575,110,64,637.9,10.5,-3.32037,52.5103,6605.0
2833,2011,SY16 2,SY16 2,Total,4253,2119,2134,4232,21,58,1144.2,3.7,-3.31354,52.5175,3782.0
2834,2011,SY16 3,SY16 3,Total,2743,1422,1321,2733,10,48,12112.08,0.2,-3.33646,52.5528,2967.0
2835,2011,SY16 4,SY16 4,Total,2551,1288,1263,2547,4,45,11424.79,0.2,-3.27317,52.4984,2667.0
2836,2011,SY17 5,SY17 5,Total,3553,1788,1765,3544,9,59,15013.3,0.2,-3.46158,52.517,3749.0
2837,2011,SY18 6,SY18 6,Total,4648,2339,2309,4598,50,74,23581.69,0.2,-3.54949,52.442,4648.0
2838,2011,SY19 7,SY19 7,Total,1169,601,568,1161,8,18,17712.22,0.1,-3.59471,52.5715,1035.0
2839,2011,SY20 8,SY20 8,Total,4577,2246,2331,4527,50,70,22083.87,0.2,-3.83959,52.583,4626.0
2840,2011,SY20 9,SY20 9,Total,2344,1155,1189,2331,13,36,27783.47,0.1,-3.79577,52.654,2291.0
2841,2011,SY21 0,SY21 0,Total,2821,1412,1409,2818,3,50,21579.27,0.1,-3.37241,52.6629,3241.0
2842,2011,SY21 7,SY21 7,Total,5948,2907,3041,5751,197,74,699.47,8.5,-3.14529,52.6611,5897.0
2843,2011,SY21 8,SY21 8,Total,4695,2341,2354,4669,26,80,14479.32,0.3,-3.13926,52.638,4695.0
2844,2011,SY21 9,SY21 9,Total,2786,1378,1408,2775,11,46,7390.88,0.4,-3.18241,52.678,3303.0
2845,2011,SY22 5,SY22 5,Total,1999,1042,957,1968,31,39,9544.14,0.2,-3.27341,52.7637,2066.0
2846,2011,SY22 6,SY22 6,Total,7535,3703,3832,7475,60,112,17366.08,0.4,-3.14788,52.7561,6788.0
2847,2011,SY23 1,SY23 1,Total,7301,3798,3503,7111,190,69,300.12,24.3,-4.0779,52.4101,7200.0
2848,2011,SY23 2,SY23 2,Total,3967,2039,1928,3199,768,52,183.4,21.6,-4.0793,52.4158,4266.0
2849,2011,SY23 3,SY23 3,Total,11362,5697,5665,8757,2605,229,17200.81,0.7,-4.02511,52.4145,10900.0
2850,2011,SY23 4,SY23 4,Total,5401,2687,2714,5329,72,100,24386.31,0.2,-4.00978,52.3531,5515.0
2851,2011,SY23 5,SY23 5,Total,2827,1398,1429,2793,34,42,7070.0,0.4,-4.14236,52.2876,3033.0
2852,2011,SY24 5,SY24 5,Total,4663,2285,2378,4628,35,79,9459.02,0.5,-4.02535,52.4692,4707.0
2853,2011,SY25 6,SY25 6,Total,4343,2122,2221,4328,15,80,43434.09,0.1,-3.93601,52.2372,4400.0
2854,2011,TA10 0,TA10 0,Total,3950,1933,2017,3927,23,85,5415.11,0.7,-2.85712,51.0229,3968.0
2855,2011,TA10 9,TA10 9,Total,5320,2562,2758,5192,128,94,5332.65,1.0,-2.8053,51.0412,5366.0
2856,2011,TA11 6,TA11 6,Total,6430,3122,3308,6380,50,132,3045.71,2.1,-2.71869,51.0637,6336.0
2857,2011,TA11 7,TA11 7,Total,2736,1279,1457,2690,46,67,6291.79,0.4,-2.68893,51.0549,2757.0
2858,2011,TA12 6,TA12 6,Total,6353,3079,3274,6306,47,95,3515.96,1.8,-2.77224,50.9742,6280.0
2859,2011,TA13 5,TA13 5,Total,3973,1897,2076,3940,33,69,1950.82,2.0,-2.8104,50.9471,3961.0
2860,2011,TA14 6,TA14 6,Total,2986,1459,1527,2986,0,49,1157.87,2.6,-2.75109,50.9479,3079.0
2861,2011,TA15 6,TA15 6,Total,831,413,418,829,2,11,593.46,1.4,-2.72213,50.9514,749.0
2862,2011,TA16 5,TA16 5,Total,1979,964,1015,1950,29,21,1096.56,1.8,-2.79303,50.9077,1893.0
2863,2011,TA17 8,TA17 8,Total,442,207,235,442,0,6,859.97,0.5,-2.836,50.9082,513.0
2864,2011,TA18 7,TA18 7,Total,3838,1851,1987,3822,16,76,2106.12,1.8,-2.77912,50.8904,3995.0
2865,2011,TA18 8,TA18 8,Total,6201,2994,3207,6158,43,61,2812.39,2.2,-2.79847,50.8744,6141.0
2866,2011,TA19 0,TA19 0,Total,5772,2752,3020,5740,32,71,3672.51,1.6,-2.89513,50.9299,5679.0
2867,2011,TA19 9,TA19 9,Total,5916,2861,3055,5834,82,87,4473.24,1.3,-2.93259,50.9374,6014.0
2868,2011,TA20 1,TA20 1,Total,7780,3852,3928,7708,72,73,467.46,16.6,-2.96006,50.8773,8140.0
2869,2011,TA20 2,TA20 2,Total,7552,3712,3840,7483,69,67,1563.75,4.8,-2.95704,50.8601,7123.0
2870,2011,TA20 3,TA20 3,Total,2690,1326,1364,2685,5,43,6483.99,0.4,-3.01207,50.8999,2719.0
2871,2011,TA20 4,TA20 4,Total,2310,1143,1167,2306,4,50,5339.07,0.4,-2.90909,50.854,2248.0
2872,2011,TA21 0,TA21 0,Total,4092,2035,2057,4036,56,84,6784.8,0.6,-3.28579,50.9821,4039.0
2873,2011,TA21 8,TA21 8,Total,7262,3493,3769,6992,270,91,356.8,20.4,-3.22852,50.9785,7293.0
2874,2011,TA21 9,TA21 9,Total,6801,3246,3555,6632,169,109,3227.83,2.1,-3.22074,50.9735,7007.0
2875,2011,TA22 9,TA22 9,Total,2619,1257,1362,2600,19,39,11216.47,0.2,-3.54676,51.0448,2660.0
2876,2011,TA23 0,TA23 0,Total,5681,2765,2916,5656,25,74,6068.17,0.9,-3.34928,51.165,5498.0
2877,2011,TA24 5,TA24 5,Total,6406,3048,3358,5352,1054,53,364.84,17.6,-3.4775,51.2056,6180.0
2878,2011,TA24 6,TA24 6,Total,5373,2508,2865,5322,51,46,4485.59,1.2,-3.43864,51.1842,5771.0
2879,2011,TA24 7,TA24 7,Total,1846,892,954,1801,45,27,20880.61,0.1,-3.59076,51.1357,1859.0
2880,2011,TA24 8,TA24 8,Total,5025,2334,2691,4916,109,54,10844.2,0.5,-3.54839,51.2044,4852.0
2881,2011,TD12 4,TD12 4,Total,1163,584,579,1148,15,37,11544.99,0.1,-2.24202,55.6529,4215.0
2882,2011,TD15 1,TD15 1,Total,5448,2627,2821,5286,162,79,2181.57,2.5,-2.02183,55.7723,6577.0
2883,2011,TD15 2,TD15 2,Total,11713,5635,6078,11507,206,133,25708.89,0.5,-2.00747,55.731,11506.0
2884,2011,TF10 7,TF10 7,Total,10514,5220,5294,10356,158,159,348.64,30.2,-2.37729,52.7688,10899.0
2885,2011,TF10 8,TF10 8,Total,4503,2284,2219,3757,746,136,6260.85,0.7,-2.41763,52.7839,4535.0
2886,2011,TF10 9,TF10 9,Total,3381,1683,1698,3261,120,69,4468.37,0.8,-2.36556,52.7493,3394.0
2887,2011,TF11 8,TF11 8,Total,6357,3155,3202,6310,47,88,7950.24,0.8,-2.35457,52.679,6397.0
2888,2011,TF11 9,TF11 9,Total,3550,1785,1765,3539,11,82,6055.51,0.6,-2.37987,52.6394,3280.0
2889,2011,TF12 5,TF12 5,Total,5609,2756,2853,5583,26,71,3272.34,1.7,-2.48087,52.6129,5378.0
2890,2011,TF13 6,TF13 6,Total,3696,1764,1932,3631,65,71,7543.22,0.5,-2.57898,52.5813,3721.0
2891,2011,TN10 3,TN10 3,Total,7971,3798,4173,7918,53,102,239.34,33.3,0.276793,51.2106,8209.0
2892,2011,TN10 4,TN10 4,Total,8312,3965,4347,8304,8,154,508.0,16.4,0.292473,51.2096,8414.0
2893,2011,TN11 0,TN11 0,Total,4404,2151,2253,4289,115,128,3160.1,1.4,0.323848,51.2073,4612.0
2894,2011,TN11 8,TN11 8,Total,3689,1801,1888,3687,2,144,4413.2,0.8,0.202509,51.1895,3408.0
2895,2011,TN11 9,TN11 9,Total,5779,2862,2917,5709,70,138,3018.49,1.9,0.269067,51.2179,5908.0
2896,2011,TN12 0,TN12 0,Total,5947,2910,3037,5805,142,105,2385.47,2.5,0.541274,51.1648,6168.0
2897,2011,TN12 5,TN12 5,Total,3306,1654,1652,3286,20,54,1288.64,2.6,0.376398,51.2125,3186.0
2898,2011,TN12 6,TN12 6,Total,10404,5127,5277,10354,50,143,2049.54,5.1,0.375373,51.1805,10416.0
2899,2011,TN12 7,TN12 7,Total,2863,1438,1425,2862,1,88,2189.37,1.3,0.377378,51.1529,2924.0
2900,2011,TN12 8,TN12 8,Total,2435,1187,1248,2435,0,66,2007.67,1.2,0.428532,51.1407,2411.0
2901,2011,TN12 9,TN12 9,Total,4520,2240,2280,4518,2,95,4020.7,1.1,0.484755,51.1772,4412.0
2902,2011,TN13 1,TN13 1,Total,5429,2617,2812,4952,477,182,352.18,15.4,0.190131,51.2677,5840.0
2903,2011,TN13 2,TN13 2,Total,9270,4531,4739,9109,161,239,949.76,9.8,0.171057,51.2812,9238.0
2904,2011,TN13 3,TN13 3,Total,10294,4998,5296,10180,114,236,773.92,13.3,0.190942,51.2806,9854.0
2905,2011,TN14 5,TN14 5,Total,6698,3282,3416,6665,33,103,1031.16,6.5,0.189249,51.2971,6548.0
2906,2011,TN14 6,TN14 6,Total,3324,1622,1702,3324,0,101,3879.66,0.9,0.156682,51.2566,3370.0
2907,2011,TN14 7,TN14 7,Total,4948,2438,2510,4948,0,97,2655.52,1.9,0.14002,51.3215,5157.0
2908,2011,TN15 0,TN15 0,Total,4231,2086,2145,4172,59,162,3104.82,1.4,0.238775,51.2741,4297.0
2909,2011,TN15 6,TN15 6,Total,9660,4682,4978,9577,83,131,3554.71,2.7,0.236878,51.3194,9652.0
2910,2011,TN15 7,TN15 7,Total,3440,1681,1759,3382,58,58,3440.27,1.0,0.299193,51.315,3592.0
2911,2011,TN15 8,TN15 8,Total,5065,2461,2604,5025,40,87,804.84,6.3,0.306227,51.2888,5234.0
2912,2011,TN15 9,TN15 9,Total,1942,967,975,1936,6,66,774.16,2.5,0.272508,51.2828,1768.0
2913,2011,TN16 1,TN16 1,Total,5023,2448,2575,5007,16,111,2386.52,2.1,0.0738516,51.2755,4905.0
2914,2011,TN16 2,TN16 2,Total,2509,1249,1260,2462,47,54,2358.25,1.1,0.0400557,51.2951,2631.0
2915,2011,TN16 3,TN16 3,Total,11761,5768,5993,11754,7,164,1189.04,9.9,0.0330912,51.3129,11559.0
2916,2011,TN17 1,TN17 1,Total,2552,1329,1223,2328,224,71,2216.71,1.2,0.467278,51.1163,2169.0
2917,2011,TN17 2,TN17 2,Total,3581,1762,1819,3494,87,130,5622.85,0.6,0.529714,51.1112,3863.0
2918,2011,TN17 3,TN17 3,Total,4799,2309,2490,4519,280,141,1668.76,2.9,0.533531,51.0941,4640.0
2919,2011,TN17 4,TN17 4,Total,3788,1622,2166,3274,514,147,5038.33,0.8,0.597534,51.0637,3795.0
2920,2011,TN18 4,TN18 4,Total,3963,1936,2027,3928,35,90,1686.35,2.4,0.507686,51.0479,3832.0
2921,2011,TN18 5,TN18 5,Total,2649,1332,1317,2621,28,85,3159.06,0.8,0.548665,51.0417,2787.0
2922,2011,TN19 7,TN19 7,Total,5000,2477,2523,4880,120,108,5387.09,0.9,0.413122,51.0043,5051.0
2923,2011,TN20 6,TN20 6,Total,3718,1798,1920,3620,98,117,4715.93,0.8,0.2539,51.0307,3451.0
2924,2011,TN21 0,TN21 0,Total,5862,2791,3071,5693,169,104,2545.3,2.3,0.234179,50.9544,6314.0
2925,2011,TN21 8,TN21 8,Total,7152,3452,3700,7090,62,123,1534.79,4.7,0.262636,50.9708,7151.0
2926,2011,TN21 9,TN21 9,Total,2969,1494,1475,2943,26,72,5007.48,0.6,0.3034,50.9499,2719.0
2927,2011,TN22 1,TN22 1,Total,6310,3007,3303,6285,25,73,270.32,23.3,0.098671,50.9743,6481.0
2928,2011,TN22 2,TN22 2,Total,3391,1639,1752,3384,7,70,563.1,6.0,0.0879819,50.9826,3184.0
2929,2011,TN22 3,TN22 3,Total,4230,2102,2128,4046,184,125,4928.22,0.9,0.0623816,51.0057,4608.0
2930,2011,TN22 4,TN22 4,Total,3480,1718,1762,3395,85,85,3728.91,0.9,0.138485,50.9936,3328.0
2931,2011,TN22 5,TN22 5,Total,8772,4260,4512,8710,62,188,4122.16,2.1,0.110142,50.9605,8828.0
2932,2011,TN23 1,TN23 1,Total,1721,866,855,1719,2,20,109.41,15.7,0.869386,51.1459,1542.0
2933,2011,TN23 3,TN23 3,Total,13916,6798,7118,13811,105,163,1784.62,7.8,0.85488,51.1395,13733.0
2934,2011,TN23 4,TN23 4,Total,5160,2563,2597,5154,6,44,173.74,29.7,0.85632,51.1426,5115.0
2935,2011,TN23 5,TN23 5,Total,14538,7020,7518,14472,66,106,346.45,42.0,0.849298,51.1357,14602.0
2936,2011,TN23 6,TN23 6,Total,1529,777,752,1529,0,7,133.71,11.4,0.864931,51.1343,1470.0
2937,2011,TN23 7,TN23 7,Total,3032,1537,1495,3032,0,23,59.06,51.3,0.87001,51.1405,3262.0
2938,2011,TN24 0,TN24 0,Total,14213,6886,7327,14099,114,129,653.05,21.8,0.895253,51.1391,14338.0
2939,2011,TN24 8,TN24 8,Total,6051,2933,3118,5816,235,55,231.52,26.1,0.875006,51.1508,6088.0
2940,2011,TN24 9,TN24 9,Total,11355,5473,5882,11303,52,127,666.18,17.0,0.884602,51.1623,11154.0
2941,2011,TN25 4,TN25 4,Total,4842,2371,2471,4842,0,73,4072.83,1.2,0.872294,51.1835,5162.0
2942,2011,TN25 5,TN25 5,Total,3585,1754,1831,3558,27,73,5844.83,0.6,0.953353,51.1682,3366.0
2943,2011,TN25 6,TN25 6,Total,4976,2387,2589,4900,76,81,3916.63,1.3,0.97979,51.1175,4902.0
2944,2011,TN25 7,TN25 7,Total,2153,1053,1100,2134,19,36,3816.35,0.6,0.914332,51.0999,2279.0
2945,2011,TN26 1,TN26 1,Total,2730,1312,1418,2703,27,38,2362.91,1.2,0.828455,51.1388,2728.0
2946,2011,TN26 2,TN26 2,Total,3484,1669,1815,3444,40,58,5241.65,0.7,0.84265,51.0633,3571.0
2947,2011,TN26 3,TN26 3,Total,4968,2454,2514,4898,70,88,6922.85,0.7,0.765747,51.1107,4895.0
2948,2011,TN27 0,TN27 0,Total,4069,1958,2111,4029,40,68,4352.9,0.9,0.786063,51.1937,4064.0
2949,2011,TN27 8,TN27 8,Total,3875,1913,1962,3871,4,103,5091.67,0.8,0.678298,51.1293,3942.0
2950,2011,TN27 9,TN27 9,Total,4460,2133,2327,4448,12,66,3362.97,1.3,0.668648,51.172,4497.0
2951,2011,TN28 8,TN28 8,Total,8455,4151,4304,8236,219,74,722.69,11.7,0.950671,50.9831,8645.0
2952,2011,TN29 0,TN29 0,Total,7442,3621,3821,7327,115,56,7206.25,1.0,0.968316,51.0213,7389.0
2953,2011,TN29 9,TN29 9,Total,6315,3181,3134,6239,76,53,10357.45,0.6,0.897303,50.9643,6012.0
2954,2011,TN30 6,TN30 6,Total,5626,2582,3044,5532,94,84,1645.89,3.4,0.687916,51.0753,5656.0
2955,2011,TN30 7,TN30 7,Total,3681,1768,1913,3677,4,74,5357.13,0.7,0.707363,51.0451,3756.0
2956,2011,TN31 6,TN31 6,Total,6443,3149,3294,6319,124,110,8236.93,0.8,0.637183,50.9716,6565.0
2957,2011,TN31 7,TN31 7,Total,7099,3432,3667,7053,46,56,5389.93,1.3,0.744508,50.9516,7091.0
2958,2011,TN32 5,TN32 5,Total,5238,2577,2661,4850,388,161,8338.27,0.6,0.488123,50.979,5169.0
2959,2011,TN33 0,TN33 0,Total,8195,3908,4287,8049,146,196,4482.23,1.8,0.499898,50.9202,8140.0
2960,2011,TN33 9,TN33 9,Total,4550,2234,2316,4428,122,77,7175.89,0.6,0.440255,50.8983,4410.0
2961,2011,TN34 1,TN34 1,Total,5736,2912,2824,5671,65,40,127.26,45.1,0.574809,50.8589,5863.0
2962,2011,TN34 2,TN34 2,Total,12297,5883,6414,12084,213,136,580.82,21.2,0.578291,50.8723,12430.0
2963,2011,TN34 3,TN34 3,Total,11658,5644,6014,11526,132,88,185.1,63.0,0.588831,50.8619,11630.0
2964,2011,TN35 4,TN35 4,Total,6721,3220,3501,6565,156,86,4198.7,1.6,0.614929,50.8898,7102.0
2965,2011,TN35 5,TN35 5,Total,10486,5069,5417,10393,93,90,594.39,17.6,0.603565,50.8687,10168.0
2966,2011,TN36 4,TN36 4,Total,2303,1102,1201,2300,3,24,2026.43,1.1,0.701344,50.9218,2330.0
2967,2011,TN37 6,TN37 6,Total,10187,5216,4971,9942,245,49,159.22,64.0,0.559074,50.8598,9900.0
2968,2011,TN37 7,TN37 7,Total,10374,4975,5399,10258,116,113,517.0,20.1,0.55367,50.8804,10770.0
2969,2011,TN38 0,TN38 0,Total,14113,6872,7241,13291,822,117,290.14,48.6,0.54931,50.8583,14058.0
2970,2011,TN38 8,TN38 8,Total,4684,2264,2420,4684,0,49,291.63,16.1,0.52942,50.8631,4804.0
2971,2011,TN38 9,TN38 9,Total,10238,4949,5289,10225,13,74,395.05,25.9,0.54198,50.873,9852.0
2972,2011,TN39 3,TN39 3,Total,10315,4763,5552,10126,189,116,324.52,31.8,0.45671,50.8404,10338.0
2973,2011,TN39 4,TN39 4,Total,9871,4607,5264,9729,142,110,1109.55,8.9,0.446275,50.8472,9642.0
2974,2011,TN39 5,TN39 5,Total,5582,2577,3005,5524,58,44,1070.64,5.2,0.464348,50.8584,5829.0
2975,2011,TN40 1,TN40 1,Total,7293,3268,4025,6865,428,50,159.66,45.7,0.478349,50.8408,7122.0
2976,2011,TN40 2,TN40 2,Total,10129,4793,5336,9680,449,92,528.6,19.2,0.486594,50.8491,10257.0
2977,2011,TQ10 9,TQ10 9,Total,4029,1903,2126,3949,80,70,7928.21,0.5,-3.81754,50.4244,3777.0
2978,2011,TQ11 0,TQ11 0,Total,4133,2011,2122,4017,116,49,4052.97,1.0,-3.78038,50.4806,4255.0
2979,2011,TQ12 1,TQ12 1,Total,11294,5414,5880,10995,299,148,581.92,19.4,-3.6181,50.53,11123.0
2980,2011,TQ12 2,TQ12 2,Total,5195,2545,2650,5161,34,56,188.11,27.6,-3.60791,50.5314,5219.0
2981,2011,TQ12 3,TQ12 3,Total,10451,5036,5415,10368,83,86,847.96,12.3,-3.59638,50.5494,10634.0
2982,2011,TQ12 4,TQ12 4,Total,8588,4220,4368,8588,0,145,2051.55,4.2,-3.58342,50.5254,8703.0
2983,2011,TQ12 5,TQ12 5,Total,8912,4243,4669,8847,65,128,2350.92,3.8,-3.60687,50.5002,8880.0
2984,2011,TQ12 6,TQ12 6,Total,8554,4544,4010,7653,901,134,6090.2,1.4,-3.65244,50.5426,8573.0
2985,2011,TQ13 0,TQ13 0,Total,6075,2998,3077,6009,66,99,3547.87,1.7,-3.60373,50.5933,6238.0
2986,2011,TQ13 7,TQ13 7,Total,5492,2628,2864,5431,61,103,11969.15,0.5,-3.75483,50.5239,5345.0
2987,2011,TQ13 8,TQ13 8,Total,3836,1842,1994,3758,78,91,11103.2,0.3,-3.81004,50.6669,3784.0
2988,2011,TQ13 9,TQ13 9,Total,7731,3712,4019,7639,92,141,9826.03,0.8,-3.68104,50.589,7426.0
2989,2011,TQ14 0,TQ14 0,Total,1762,843,919,1726,36,27,303.78,5.8,-3.50986,50.5396,1760.0
2990,2011,TQ14 8,TQ14 8,Total,7484,3540,3944,7187,297,78,389.74,19.2,-3.4965,50.5507,7342.0
2991,2011,TQ14 9,TQ14 9,Total,10215,4859,5356,9943,272,128,1867.08,5.5,-3.51761,50.5527,10275.0
2992,2011,TR10 8,TR10 8,Total,7093,3482,3611,7093,0,59,338.06,21.0,-5.10631,50.1675,6765.0
2993,2011,TR10 9,TR10 9,Total,4165,2045,2120,3012,1153,42,2760.38,1.5,-5.13775,50.1643,4369.0
2994,2011,TR11 2,TR11 2,Total,8326,3933,4393,8326,0,68,167.73,49.6,-5.08304,50.1571,8416.0
2995,2011,TR11 3,TR11 3,Total,4708,2276,2432,4706,2,74,71.31,66.0,-5.0742,50.1529,4292.0
2996,2011,TR11 4,TR11 4,Total,6783,3211,3572,6783,0,71,314.87,21.5,-5.07967,50.1496,7393.0
2997,2011,TR11 5,TR11 5,Total,9009,4347,4662,8956,53,120,5914.81,1.5,-5.10912,50.1429,8633.0
2998,2011,TR12 6,TR12 6,Total,4128,2074,2054,4099,29,58,8869.68,0.5,-5.14078,50.0641,3919.0
2999,2011,TR12 7,TR12 7,Total,5456,2979,2477,4718,738,69,7394.95,0.7,-5.23022,50.0234,5563.0
3000,2011,TR13 0,TR13 0,Total,4280,2122,2158,4271,9,57,5237.94,0.8,-5.26709,50.1317,4562.0
3001,2011,TR13 8,TR13 8,Total,10090,4844,5246,10050,40,137,1040.13,9.7,-5.271,50.1015,9935.0
3002,2011,TR13 9,TR13 9,Total,5453,2646,2807,5453,0,63,3125.96,1.7,-5.32666,50.0984,5311.0
3003,2011,TR14 0,TR14 0,Total,4673,2269,2404,4641,32,46,4538.14,1.0,-5.30732,50.2096,4607.0
3004,2011,TR14 7,TR14 7,Total,8751,4172,4579,8742,9,66,383.51,22.8,-5.29904,50.2124,8748.0
3005,2011,TR14 8,TR14 8,Total,8832,4324,4508,8768,64,54,226.93,38.9,-5.29333,50.2163,8347.0
3006,2011,TR14 9,TR14 9,Total,2376,1166,1210,2376,0,15,885.43,2.7,-5.28033,50.1952,2882.0
3007,2011,TR15 1,TR15 1,Total,6060,2910,3150,5975,85,31,482.99,12.5,-5.22624,50.2387,5961.0
3008,2011,TR15 2,TR15 2,Total,6140,3029,3111,6010,130,39,442.28,13.9,-5.22492,50.2313,5769.0
3009,2011,TR15 3,TR15 3,Total,7894,3883,4011,7891,3,52,964.24,8.2,-5.25825,50.2298,7819.0
3010,2011,TR16 4,TR16 4,Total,5380,2646,2734,5380,0,49,1731.17,3.1,-5.26026,50.2512,5299.0
3011,2011,TR16 5,TR16 5,Total,5115,2469,2646,5110,5,36,1279.95,4.0,-5.19525,50.24,5479.0
3012,2011,TR16 6,TR16 6,Total,3665,1785,1880,3633,32,32,2340.07,1.6,-5.21591,50.2076,4260.0
3013,2011,TR17 0,TR17 0,Total,1447,670,777,1390,57,9,299.53,4.8,-5.47041,50.1254,1557.0
3014,2011,TR18 2,TR18 2,Total,5246,2551,2695,5172,74,53,91.28,57.5,-5.53747,50.1209,5361.0
3015,2011,TR18 3,TR18 3,Total,6371,2978,3393,6243,128,60,438.08,14.5,-5.5395,50.1274,6022.0
3016,2011,TR18 4,TR18 4,Total,4719,2161,2558,4537,182,52,144.5,32.7,-5.54303,50.116,4737.0
3017,2011,TR18 5,TR18 5,Total,3536,1709,1827,3484,52,35,249.15,14.2,-5.55,50.1039,3516.0
3018,2011,TR19 6,TR19 6,Total,3300,1617,1683,3223,77,44,5037.23,0.7,-5.58448,50.0789,3406.0
3019,2011,TR19 7,TR19 7,Total,5733,2806,2927,5603,130,70,4546.95,1.3,-5.66725,50.1242,5567.0
3020,2011,TR20 8,TR20 8,Total,4709,2286,2423,4589,120,86,7458.6,0.6,-5.5416,50.138,5154.0
3021,2011,TR20 9,TR20 9,Total,4584,2161,2423,4489,95,63,3032.9,1.5,-5.42358,50.1217,4370.0
3022,2011,TR21 0,TR21 0,Total,1723,858,865,1647,76,52,656.73,2.6,-6.18766,49.9482,1723.0
3023,2011,TR22 0,TR22 0,Total,169,85,84,168,1,13,322.48,0.5,-6.34198,49.8936,85.0
3024,2011,TR24 0,TR24 0,Total,175,93,82,175,0,10,382.71,0.5,-6.33532,49.9554,175.0
3025,2011,TR25 0,TR25 0,Total,136,66,70,133,3,4,275.55,0.5,-6.29114,49.9634,136.0
3026,2011,TR26 1,TR26 1,Total,3741,1716,2025,3674,67,34,91.82,40.7,-5.48463,50.2115,3560.0
3027,2011,TR26 2,TR26 2,Total,6225,2965,3260,5974,251,77,518.38,12.0,-5.47688,50.2011,6145.0
3028,2011,TR26 3,TR26 3,Total,1676,806,870,1558,118,26,2900.16,0.6,-5.4761,50.1891,1976.0
3029,2011,TR27 4,TR27 4,Total,7292,3504,3788,7114,178,60,420.52,17.3,-5.41327,50.1878,6959.0
3030,2011,TR27 5,TR27 5,Total,4287,2095,2192,4162,125,27,3278.39,1.3,-5.38667,50.1949,4438.0
3031,2011,TR27 6,TR27 6,Total,3187,1561,1626,3172,15,44,2932.85,1.1,-5.41665,50.1665,3379.0
3032,2011,TS10 1,TS10 1,Total,6995,3535,3460,6860,135,54,174.6,40.1,-1.07508,54.6126,6763.0
3033,2011,TS10 2,TS10 2,Total,11089,5381,5708,11045,44,149,586.55,18.9,-1.05796,54.602,10841.0
3034,2011,TS10 3,TS10 3,Total,5437,2671,2766,5394,43,44,110.49,49.2,-1.05742,54.612,5680.0
3035,2011,TS10 4,TS10 4,Total,8928,4217,4711,8798,130,52,193.18,46.2,-1.0759,54.5991,9206.0
3036,2011,TS10 5,TS10 5,Total,4624,2211,2413,4624,0,18,1877.54,2.5,-1.09482,54.6059,4759.0
3037,2011,TS11 6,TS11 6,Total,3893,1909,1984,3863,30,43,467.52,8.3,-1.04257,54.592,3785.0
3038,2011,TS11 7,TS11 7,Total,4389,2087,2302,4389,0,40,329.42,13.3,-1.01642,54.5914,4474.0
3039,2011,TS11 8,TS11 8,Total,3663,1797,1866,3654,9,29,2732.57,1.3,-1.04391,54.58,3563.0
3040,2011,TS12 1,TS12 1,Total,5958,2872,3086,5717,241,64,307.54,19.4,-0.977757,54.5796,6028.0
3041,2011,TS12 2,TS12 2,Total,12848,6291,6557,12816,32,108,2164.87,5.9,-0.961241,54.5642,12793.0
3042,2011,TS12 3,TS12 3,Total,3708,1870,1838,3682,26,19,3951.96,0.9,-0.965701,54.5353,3672.0
3043,2011,TS13 4,TS13 4,Total,7988,3988,4000,7906,82,31,4153.38,1.9,-0.887782,54.554,8003.0
3044,2011,TS13 5,TS13 5,Total,2381,1180,1201,2371,10,29,4909.02,0.5,-0.788621,54.5422,2267.0
3045,2011,TS14 6,TS14 6,Total,6875,3303,3572,6780,95,67,2113.42,3.3,-1.0571,54.5371,6997.0
3046,2011,TS14 7,TS14 7,Total,5767,2818,2949,5674,93,76,1392.7,4.1,-1.05421,54.5286,5737.0
3047,2011,TS14 8,TS14 8,Total,4985,2421,2564,4919,66,91,1997.03,2.5,-1.0762,54.5284,4814.0
3048,2011,TS15 0,TS15 0,Total,2404,1193,1211,2404,0,70,3646.23,0.7,-1.29176,54.4612,2381.0
3049,2011,TS15 9,TS15 9,Total,10398,5267,5131,10070,328,192,2913.81,3.6,-1.3466,54.5033,10512.0
3050,2011,TS16 0,TS16 0,Total,7444,3608,3836,7338,106,129,1963.49,3.8,-1.35614,54.5274,7390.0
3051,2011,TS16 9,TS16 9,Total,3005,1447,1558,3005,0,54,254.13,11.8,-1.34718,54.5225,3032.0
3052,2011,TS17 0,TS17 0,Total,13994,6935,7059,13973,21,216,402.46,34.8,-1.3088,54.5272,14377.0
3053,2011,TS17 5,TS17 5,Total,10340,5122,5218,10303,37,125,347.1,29.8,-1.32431,54.5253,10115.0
3054,2011,TS17 6,TS17 6,Total,4371,2167,2204,3773,598,60,105.01,41.6,-1.30494,54.5577,4165.0
3055,2011,TS17 7,TS17 7,Total,2160,1048,1112,2122,38,14,236.57,9.1,-1.29581,54.5551,2208.0
3056,2011,TS17 8,TS17 8,Total,6499,3194,3305,6455,44,39,147.97,43.9,-1.2988,54.5471,6484.0
3057,2011,TS17 9,TS17 9,Total,7755,3683,4072,7684,71,36,346.39,22.4,-1.29098,54.5378,7792.0
3058,2011,TS18 1,TS18 1,Total,2329,1219,1110,2277,52,17,55.68,41.8,-1.31633,54.5649,2431.0
3059,2011,TS18 2,TS18 2,Total,3341,2061,1280,2338,1003,15,398.2,8.4,-1.30134,54.5707,2996.0
3060,2011,TS18 3,TS18 3,Total,6007,3116,2891,5609,398,56,460.54,13.0,-1.32195,54.5554,6213.0
3061,2011,TS18 4,TS18 4,Total,6292,3117,3175,6235,57,79,200.17,31.4,-1.33218,54.5642,6097.0
3062,2011,TS18 5,TS18 5,Total,6908,3339,3569,6853,55,93,432.9,16.0,-1.34908,54.5572,6982.0
3063,2011,TS19 0,TS19 0,Total,12340,5944,6396,12277,63,79,309.72,39.8,-1.33202,54.5746,12172.0
3064,2011,TS19 7,TS19 7,Total,8982,4265,4717,8889,93,101,293.48,30.6,-1.35578,54.5675,9032.0
3065,2011,TS19 8,TS19 8,Total,10013,4795,5218,9924,89,50,325.79,30.7,-1.35271,54.5832,10292.0
3066,2011,TS19 9,TS19 9,Total,5780,2775,3005,5753,27,18,137.73,42.0,-1.33902,54.5879,5611.0
3067,2011,TS20 1,TS20 1,Total,11234,5482,5752,11214,20,130,360.93,31.1,-1.31883,54.5906,11188.0
3068,2011,TS20 2,TS20 2,Total,9503,4711,4792,9306,197,55,251.32,37.8,-1.31025,54.5806,9658.0
3069,2011,TS21 1,TS21 1,Total,3934,1957,1977,3853,81,60,5986.82,0.7,-1.4072,54.5799,4004.0
3070,2011,TS21 2,TS21 2,Total,2977,1467,1510,2977,0,59,3690.19,0.8,-1.45312,54.6446,2698.0
3071,2011,TS21 3,TS21 3,Total,3171,1547,1624,3110,61,32,6670.44,0.5,-1.41661,54.6387,3223.0
3072,2011,TS21 4,TS21 4,Total,2588,1248,1340,2588,0,25,992.27,2.6,-1.42774,54.6748,2568.0
3073,2011,TS22 5,TS22 5,Total,8506,4163,4343,8468,38,136,2993.87,2.8,-1.32109,54.6209,8662.0
3074,2011,TS23 1,TS23 1,Total,5989,2941,3048,5896,93,46,626.97,9.6,-1.29121,54.5926,5997.0
3075,2011,TS23 2,TS23 2,Total,7748,3645,4103,7734,14,45,168.44,46.0,-1.29459,54.6061,7997.0
3076,2011,TS23 3,TS23 3,Total,14796,7164,7632,14633,163,148,423.25,35.0,-1.2826,54.6167,14647.0
3077,2011,TS23 4,TS23 4,Total,1692,827,865,1692,0,10,215.66,7.8,-1.27268,54.602,1601.0
3078,2011,TS24 0,TS24 0,Total,6441,3288,3153,6335,106,34,287.97,22.4,-1.19577,54.6974,6283.0
3079,2011,TS24 7,TS24 7,Total,1320,668,652,1320,0,8,69.55,19.0,-1.20894,54.6832,1761.0
3080,2011,TS24 8,TS24 8,Total,6147,2999,3148,6138,9,29,178.59,34.4,-1.21858,54.6929,6311.0
3081,2011,TS24 9,TS24 9,Total,7932,3818,4114,7843,89,55,338.46,23.4,-1.23141,54.708,7900.0
3082,2011,TS25 1,TS25 1,Total,9183,4426,4757,9049,134,80,1605.08,5.7,-1.20566,54.6666,8877.0
3083,2011,TS25 2,TS25 2,Total,7798,3794,4004,7762,36,102,1352.96,5.8,-1.22418,54.6514,7657.0
3084,2011,TS25 3,TS25 3,Total,5621,2662,2959,5615,6,18,106.26,52.9,-1.23841,54.6589,6081.0
3085,2011,TS25 4,TS25 4,Total,5822,2751,3071,5694,128,39,176.2,33.0,-1.24028,54.668,6090.0
3086,2011,TS25 5,TS25 5,Total,10403,4998,5405,10278,125,69,238.52,43.6,-1.22313,54.6709,9913.0
3087,2011,TS26 0,TS26 0,Total,12751,6123,6628,12668,83,161,634.87,20.1,-1.24109,54.6928,12923.0
3088,2011,TS26 8,TS26 8,Total,5546,2814,2732,5539,7,40,66.49,83.4,-1.22321,54.6877,5897.0
3089,2011,TS26 9,TS26 9,Total,7153,3553,3600,6977,176,78,119.81,59.7,-1.22186,54.6817,6459.0
3090,2011,TS27 3,TS27 3,Total,5389,2603,2786,5389,0,59,2233.41,2.4,-1.2715,54.6993,5321.0
3091,2011,TS27 4,TS27 4,Total,6938,3370,3568,6890,48,45,3251.93,2.1,-1.29858,54.7374,6872.0
3092,2011,TS28 5,TS28 5,Total,5277,2545,2732,5257,20,41,1435.1,3.7,-1.37496,54.7256,5318.0
3093,2011,TS29 6,TS29 6,Total,6266,3061,3205,6194,72,39,1226.65,5.1,-1.41998,54.7112,6313.0
3094,2011,TW10 5,TW10 5,Total,2986,1418,1568,2986,0,67,355.4,8.4,-0.292812,51.4523,3357.0
3095,2011,TW10 6,TW10 6,Total,8397,4111,4286,8022,375,149,200.68,41.8,-0.299518,51.4587,8510.0
3096,2011,TW10 7,TW10 7,Total,7769,3754,4015,7748,21,142,583.35,13.3,-0.311715,51.4419,7718.0
3097,2011,TW11 0,TW11 0,Total,6598,3208,3390,6488,110,147,389.7,16.9,-0.33889,51.4262,6615.0
3098,2011,TW11 8,TW11 8,Total,8507,4101,4406,8498,9,141,118.78,71.6,-0.335117,51.4289,7924.0
3099,2011,TW11 9,TW11 9,Total,8305,3992,4313,8228,77,204,161.98,51.3,-0.323549,51.4244,8659.0
3100,2011,TW12 1,TW12 1,Total,7030,3400,3630,6915,115,145,159.83,44.0,-0.363609,51.4259,7030.0
3101,2011,TW12 2,TW12 2,Total,9427,4512,4915,9310,117,226,340.07,27.7,-0.369791,51.4163,9167.0
3102,2011,TW12 3,TW12 3,Total,6553,3119,3434,6512,41,123,131.21,49.9,-0.375768,51.4241,7032.0
3103,2011,TW13 4,TW13 4,Total,12679,6383,6296,12511,168,83,294.67,43.0,-0.417917,51.4409,12919.0
3104,2011,TW13 5,TW13 5,Total,9537,4739,4798,9537,0,69,240.65,39.6,-0.392381,51.4426,9455.0
3105,2011,TW13 6,TW13 6,Total,8306,4058,4248,8289,17,61,308.13,27.0,-0.390359,51.4351,8705.0
3106,2011,TW13 7,TW13 7,Total,5736,2838,2898,5736,0,41,180.59,31.8,-0.408368,51.4383,5068.0
3107,2011,TW14 0,TW14 0,Total,6093,3020,3073,6093,0,52,236.4,25.8,-0.407564,51.4563,6294.0
3108,2011,TW14 8,TW14 8,Total,9711,4765,4946,9693,18,71,392.37,24.7,-0.434374,51.4494,9422.0
3109,2011,TW14 9,TW14 9,Total,12219,6051,6168,12067,152,94,225.96,54.1,-0.418001,51.4509,12270.0
3110,2011,TW15 1,TW15 1,Total,10483,5136,5347,10483,0,95,228.78,45.8,-0.443584,51.4271,10475.0
3111,2011,TW15 2,TW15 2,Total,8024,3935,4089,7968,56,89,180.45,44.5,-0.459398,51.4316,8263.0
3112,2011,TW15 3,TW15 3,Total,8955,4412,4543,8673,282,99,248.31,36.1,-0.46976,51.4337,9086.0
3113,2011,TW16 5,TW16 5,Total,5046,2457,2589,5046,0,78,302.59,16.7,-0.407698,51.4139,4934.0
3114,2011,TW16 6,TW16 6,Total,5601,2731,2870,5515,86,83,228.76,24.5,-0.418192,51.4112,5969.0
3115,2011,TW16 7,TW16 7,Total,9496,4727,4769,9407,89,75,221.85,42.8,-0.423638,51.4217,9577.0
3116,2011,TW17 0,TW17 0,Total,5308,2629,2679,5308,0,48,347.75,15.3,-0.457019,51.4029,5349.0
3117,2011,TW17 8,TW17 8,Total,6423,3129,3294,6377,46,83,407.25,15.8,-0.439091,51.3976,6032.0
3118,2011,TW17 9,TW17 9,Total,2511,1222,1289,2511,0,45,321.69,7.8,-0.450908,51.3918,2720.0
3119,2011,TW18 1,TW18 1,Total,8919,4342,4577,8800,119,93,532.24,16.8,-0.49707,51.4244,8768.0
3120,2011,TW18 2,TW18 2,Total,7545,3666,3879,7545,0,88,239.78,31.5,-0.506134,51.4245,7508.0
3121,2011,TW18 3,TW18 3,Total,4396,2189,2207,4392,4,49,227.51,19.3,-0.521846,51.4292,4087.0
3122,2011,TW18 4,TW18 4,Total,5313,2700,2613,5282,31,57,504.09,10.5,-0.512033,51.4351,5099.0
3123,2011,TW19 5,TW19 5,Total,3954,1974,1980,3947,7,70,654.36,6.0,-0.551107,51.4526,3903.0
3124,2011,TW19 6,TW19 6,Total,1371,696,675,1371,0,10,262.96,5.2,-0.511579,51.4556,1713.0
3125,2011,TW19 7,TW19 7,Total,10694,5316,5378,10642,52,66,468.32,22.8,-0.479551,51.451,10664.0
3126,2011,TW20 0,TW20 0,Total,10297,4811,5486,7898,2399,219,867.42,11.9,-0.569232,51.4303,10199.0
3127,2011,TW20 8,TW20 8,Total,7854,3889,3965,7706,148,127,899.65,8.7,-0.531786,51.4227,7746.0
3128,2011,TW20 9,TW20 9,Total,6694,3156,3538,6694,0,83,317.58,21.1,-0.545807,51.4296,6986.0
3129,2011,UB10 0,UB10 0,Total,10714,5256,5458,10652,62,160,254.9,42.0,-0.458274,51.5357,10795.0
3130,2011,UB10 8,UB10 8,Total,12043,5901,6142,11994,49,246,669.16,18.0,-0.454078,51.5606,12100.0
3131,2011,UB10 9,UB10 9,Total,10737,5272,5465,10718,19,180,383.88,28.0,-0.453825,51.5453,10730.0
3132,2011,WA10 1,WA10 1,Total,2309,1195,1114,2309,0,10,65.69,35.1,-2.73603,53.4537,2337.0
3133,2011,WA10 2,WA10 2,Total,4791,2428,2363,4685,106,35,104.24,46.0,-2.74419,53.4567,4820.0
3134,2011,WA10 3,WA10 3,Total,9461,4669,4792,9410,51,68,296.76,31.9,-2.75871,53.4429,9381.0
3135,2011,WA10 4,WA10 4,Total,8230,4072,4158,8181,49,85,155.44,52.9,-2.75955,53.4534,8711.0
3136,2011,WA10 5,WA10 5,Total,6049,2953,3096,5992,57,86,589.48,10.3,-2.77856,53.4559,5584.0
3137,2011,WA10 6,WA10 6,Total,7808,3832,3976,7745,63,84,659.01,11.8,-2.75564,53.4639,7692.0
3138,2011,WA11 0,WA11 0,Total,16250,7963,8287,16186,64,119,1121.16,14.5,-2.67478,53.4668,15920.0
3139,2011,WA11 7,WA11 7,Total,6603,3211,3392,6585,18,55,1970.0,3.4,-2.75226,53.4839,6616.0
3140,2011,WA11 8,WA11 8,Total,5910,2792,3118,5865,45,99,1031.84,5.7,-2.77733,53.498,6190.0
3141,2011,WA11 9,WA11 9,Total,11753,5799,5954,11733,20,77,483.8,24.3,-2.70118,53.468,11852.0
3142,2011,WA12 0,WA12 0,Total,4310,2122,2188,4310,0,31,436.51,9.9,-2.62945,53.4597,4547.0
3143,2011,WA12 8,WA12 8,Total,7921,3853,4068,7823,98,72,348.78,22.7,-2.62653,53.4479,7602.0
3144,2011,WA12 9,WA12 9,Total,9802,4871,4931,9778,24,76,393.55,24.9,-2.64081,53.4541,10040.0
3145,2011,WA13 0,WA13 0,Total,6748,3269,3479,6662,86,163,1328.12,5.1,-2.47053,53.3775,6613.0
3146,2011,WA13 9,WA13 9,Total,6082,3011,3071,6079,3,132,1399.38,4.3,-2.46116,53.3874,6286.0
3147,2011,WA14 1,WA14 1,Total,3101,1527,1574,3095,6,42,60.05,51.6,-2.34729,53.3905,3418.0
3148,2011,WA14 2,WA14 2,Total,5621,2731,2890,5493,128,132,194.82,28.9,-2.35262,53.3819,5386.0
3149,2011,WA14 3,WA14 3,Total,4388,2137,2251,4320,68,154,376.67,11.6,-2.36253,53.373,4813.0
3150,2011,WA14 4,WA14 4,Total,6833,3373,3460,6660,173,133,953.82,7.2,-2.36138,53.3894,6505.0
3151,2011,WA14 5,WA14 5,Total,7747,3837,3910,7747,0,74,772.79,10.0,-2.35895,53.3997,8115.0
3152,2011,WA15 0,WA15 0,Total,4983,2447,2536,4971,12,212,1895.16,2.6,-2.32254,53.3679,4496.0
3153,2011,WA15 6,WA15 6,Total,12652,6212,6440,12607,45,231,297.99,42.5,-2.32972,53.399,12315.0
3154,2011,WA15 7,WA15 7,Total,10409,5021,5388,10372,37,180,254.22,40.9,-2.32018,53.3918,11159.0
3155,2011,WA15 8,WA15 8,Total,8834,4263,4571,8781,53,214,516.92,17.1,-2.325,53.3801,8814.0
3156,2011,WA15 9,WA15 9,Total,5786,2832,2954,5786,0,208,137.44,42.1,-2.34132,53.3795,5994.0
3157,2011,WA16 0,WA16 0,Total,5896,2846,3050,5837,59,135,5147.3,1.1,-2.41266,53.3079,5383.0
3158,2011,WA16 6,WA16 6,Total,2946,1407,1539,2888,58,59,2360.43,1.2,-2.39047,53.3245,3278.0
3159,2011,WA16 7,WA16 7,Total,3308,1575,1733,3126,182,61,2373.85,1.4,-2.31643,53.3131,3205.0
3160,2011,WA16 8,WA16 8,Total,7640,3709,3931,7592,48,137,1419.36,5.4,-2.35265,53.2994,7846.0
3161,2011,WA16 9,WA16 9,Total,3754,1842,1912,3719,35,89,3280.52,1.1,-2.37628,53.274,3705.0
3162,2011,WC1A 1,WC1A 1,Total,268,152,116,268,0,0,0.97,276.3,-0.126865,51.517,386.0
3163,2011,WC1A 2,WC1A 2,Total,277,138,139,277,0,1,1.36,203.7,-0.123735,51.518,525.0
3164,2011,WC1B 3,WC1B 3,Total,1091,536,555,928,163,8,27.53,39.6,-0.128456,51.5182,798.0
3165,2011,WC1B 4,WC1B 4,Total,576,287,289,552,24,15,6.6,87.3,-0.122984,51.5195,260.0
3166,2011,WC1E 6,WC1E 6,Total,1281,680,601,868,413,17,10.84,118.2,-0.134116,51.5216,1174.0
3167,2011,WC1E 7,WC1E 7,Total,1001,525,476,856,145,10,14.57,68.7,-0.131164,51.52,1082.0
3168,2011,WC1H 0,WC1H 0,Total,1283,574,709,863,420,17,6.54,196.2,-0.129045,51.524,1377.0
3169,2011,WC1H 8,WC1H 8,Total,2872,1430,1442,2812,60,19,16.16,177.7,-0.123109,51.5258,2802.0
3170,2011,WC1H 9,WC1H 9,Total,4173,2052,2121,2971,1202,28,19.36,215.5,-0.126209,51.5249,4093.0
3171,2011,WC1N 1,WC1N 1,Total,3196,1579,1617,2624,572,17,19.1,167.3,-0.12442,51.5229,3312.0
3172,2011,WC1N 2,WC1N 2,Total,1623,895,728,1467,156,18,9.66,168.0,-0.117665,51.5219,1238.0
3173,2011,WC1N 3,WC1N 3,Total,2476,1284,1192,2455,21,21,15.15,163.4,-0.119726,51.5212,2534.0
3174,2011,WC1R 4,WC1R 4,Total,630,333,297,629,1,14,10.89,57.9,-0.118126,51.5191,518.0
3175,2011,WC1V 6,WC1V 6,Total,367,192,175,367,0,4,22.17,16.6,-0.118126,51.5179,181.0
3176,2011,WC1V 7,WC1V 7,Total,593,314,279,237,356,4,1.84,322.3,-0.118202,51.5175,365.0
3177,2011,WC1X 0,WC1X 0,Total,3337,1657,1680,2962,375,38,16.66,200.3,-0.115175,51.5246,3127.0
3178,2011,WC1X 8,WC1X 8,Total,311,179,132,311,0,0,1.76,176.7,-0.1177,51.5226,1142.0
3179,2011,WC1X 9,WC1X 9,Total,4305,2107,2198,3573,732,39,24.26,177.5,-0.118019,51.5264,3845.0
3180,2011,WC2B 4,WC2B 4,Total,652,350,302,526,126,2,1.27,513.4,-0.119073,51.5136,545.0
3181,2011,WC2B 5,WC2B 5,Total,1255,742,513,1188,67,6,14.9,84.2,-0.122282,51.5153,1277.0
3182,2011,WC2E 7,WC2E 7,Total,641,346,295,568,73,6,40.72,15.7,-0.121894,51.5118,307.0
3183,2011,WC2E 9,WC2E 9,Total,264,155,109,264,0,0,6.05,43.6,-0.125027,51.5132,278.0
3184,2011,WC2H 0,WC2H 0,Total,778,448,330,778,0,1,7.52,103.5,-0.128633,51.5126,538.0
3185,2011,WC2H 7,WC2H 7,Total,243,134,109,243,0,2,1.31,185.5,-0.129206,51.512,386.0
3186,2011,WC2H 8,WC2H 8,Total,197,105,92,197,0,6,4.8,41.0,-0.127649,51.5156,521.0
3187,2011,WC2H 9,WC2H 9,Total,1273,663,610,1244,29,9,7.47,170.4,-0.126047,51.5145,1487.0
3188,2011,WC2N 4,WC2N 4,Total,279,171,108,238,41,1,6.57,42.5,-0.12653,51.5115,364.0
3189,2011,WC2N 5,WC2N 5,Total,463,238,225,256,207,6,33.38,13.9,-0.125706,51.5083,296.0
3190,2011,WC2N 6,WC2N 6,Total,290,163,127,290,0,0,7.52,38.6,-0.123588,51.5094,201.0
3191,2011,WD17 1,WD17 1,Total,1087,607,480,1076,11,13,27.9,39.0,-0.40406,51.6579,1146.0
3192,2011,WD17 2,WD17 2,Total,3208,1659,1549,3165,43,13,74.14,43.3,-0.396161,51.6543,3221.0
3193,2011,WD17 3,WD17 3,Total,3886,1921,1965,3884,2,137,303.42,12.8,-0.417255,51.6617,3933.0
3194,2011,WD17 4,WD17 4,Total,7606,3735,3871,7358,248,149,179.01,42.5,-0.412187,51.6677,7528.0
3195,2011,WD18 0,WD18 0,Total,7819,4008,3811,7788,31,80,137.64,56.8,-0.403451,51.6516,8408.0
3196,2011,WD18 6,WD18 6,Total,4984,2327,2657,4883,101,37,147.76,33.7,-0.416773,51.6457,4747.0
3197,2011,WD18 7,WD18 7,Total,10891,5579,5312,10789,102,158,197.15,55.2,-0.416979,51.6524,10455.0
3198,2011,WD18 8,WD18 8,Total,640,338,302,640,0,8,75.52,8.5,-0.427287,51.646,651.0
3199,2011,WD19 4,WD19 4,Total,9844,4819,5025,9776,68,226,368.09,26.7,-0.395446,51.6429,10013.0
3200,2011,WD19 5,WD19 5,Total,4861,2304,2557,4839,22,81,234.82,20.7,-0.385944,51.6316,4855.0
3201,2011,WD19 6,WD19 6,Total,7094,3373,3721,7025,69,64,181.34,39.1,-0.392012,51.6218,7211.0
3202,2011,WD19 7,WD19 7,Total,5576,2716,2860,5575,1,44,179.29,31.1,-0.397425,51.6287,5459.0
3203,2011,WD23 1,WD23 1,Total,5754,2715,3039,5611,143,175,461.42,12.5,-0.355643,51.6381,6164.0
3204,2011,WD23 2,WD23 2,Total,8118,3960,4158,7887,231,165,414.44,19.6,-0.380426,51.654,7633.0
3205,2011,WD23 3,WD23 3,Total,5457,2590,2867,5420,37,96,186.51,29.3,-0.365244,51.6472,5476.0
3206,2011,WD23 4,WD23 4,Total,6311,3064,3247,6268,43,142,350.14,18.0,-0.353842,51.6426,6074.0
3207,2011,WD24 4,WD24 4,Total,4148,2093,2055,4143,5,31,99.81,41.6,-0.398378,51.663,4220.0
3208,2011,WD24 5,WD24 5,Total,6759,3380,3379,6692,67,71,106.53,63.4,-0.408648,51.6724,6887.0
3209,2011,WD24 6,WD24 6,Total,5170,2596,2574,5170,0,44,78.15,66.2,-0.40303,51.6735,5309.0
3210,2011,WD24 7,WD24 7,Total,5538,2799,2739,5538,0,79,126.3,43.8,-0.394702,51.6715,5411.0
3211,2011,WD25 0,WD25 0,Total,8042,3877,4165,8003,39,93,161.49,49.8,-0.400822,51.6855,7786.0
3212,2011,WD25 7,WD25 7,Total,8271,4040,4231,8224,47,95,386.59,21.4,-0.407057,51.6887,7983.0
3213,2011,WD25 8,WD25 8,Total,1355,697,658,1242,113,33,921.41,1.5,-0.359365,51.6674,1465.0
3214,2011,WD25 9,WD25 9,Total,10140,4852,5288,10125,15,97,293.08,34.6,-0.389062,51.6809,10477.0
3215,2011,WF10 1,WF10 1,Total,2527,1262,1265,2527,0,11,140.88,17.9,-1.36029,53.7256,2602.0
3216,2011,WF10 2,WF10 2,Total,8967,4355,4612,8819,148,49,1666.9,5.4,-1.34795,53.7396,8470.0
3217,2011,WF10 3,WF10 3,Total,12553,6142,6411,12545,8,99,417.08,30.1,-1.32003,53.7213,12984.0
3218,2011,WF10 4,WF10 4,Total,10919,5334,5585,10831,88,78,388.64,28.1,-1.34505,53.7195,10619.0
3219,2011,WF10 5,WF10 5,Total,10491,5198,5293,10318,173,75,810.49,12.9,-1.36882,53.7162,10604.0
3220,2011,WF11 0,WF11 0,Total,5997,2920,3077,5980,17,32,1106.57,5.4,-1.25351,53.7002,6199.0
3221,2011,WF11 8,WF11 8,Total,6439,3179,3260,6396,43,24,534.47,12.0,-1.26128,53.709,6423.0
3222,2011,WF11 9,WF11 9,Total,4548,2232,2316,4485,63,32,2472.21,1.8,-1.26174,53.7231,4461.0
3223,2011,WF12 0,WF12 0,Total,9577,4672,4905,9534,43,83,1049.59,9.1,-1.6303,53.6682,9830.0
3224,2011,WF12 7,WF12 7,Total,8101,3951,4150,8024,77,61,487.92,16.6,-1.61194,53.6997,8591.0
3225,2011,WF12 8,WF12 8,Total,6510,3188,3322,6510,0,24,213.3,30.5,-1.61222,53.688,6466.0
3226,2011,WF12 9,WF12 9,Total,9788,4997,4791,9590,198,61,381.0,25.7,-1.63441,53.6811,9603.0
3227,2011,WF13 1,WF13 1,Total,1486,772,714,1486,0,5,77.49,19.2,-1.63066,53.6923,1291.0
3228,2011,WF13 2,WF13 2,Total,6386,3272,3114,6170,216,57,153.74,41.5,-1.63741,53.6942,6014.0
3229,2011,WF13 3,WF13 3,Total,11450,5713,5737,11410,40,41,273.01,41.9,-1.65873,53.6834,11447.0
3230,2011,WF13 4,WF13 4,Total,8140,4025,4115,8077,63,46,194.54,41.8,-1.65114,53.6994,8769.0
3231,2011,WF14 0,WF14 0,Total,7146,3439,3707,7075,71,71,387.53,18.4,-1.69135,53.6878,7270.0
3232,2011,WF14 8,WF14 8,Total,3909,1948,1961,3835,74,49,689.46,5.7,-1.69252,53.6709,3848.0
3233,2011,WF14 9,WF14 9,Total,8508,4071,4437,8462,46,102,276.1,30.8,-1.69025,53.6817,8774.0
3234,2011,WF15 6,WF15 6,Total,5161,2511,2650,5102,59,40,187.39,27.5,-1.69221,53.7121,5236.0
3235,2011,WF15 7,WF15 7,Total,7511,3731,3780,7509,2,59,355.29,21.1,-1.69033,53.7032,7549.0
3236,2011,WF15 8,WF15 8,Total,5025,2432,2593,4980,45,41,635.57,7.9,-1.72206,53.7107,4945.0
3237,2011,WF16 0,WF16 0,Total,4858,2403,2455,4800,58,26,127.59,38.1,-1.66882,53.7059,4161.0
3238,2011,WF16 9,WF16 9,Total,7765,3813,3952,7696,69,36,183.97,42.2,-1.66996,53.7129,8135.0
3239,2011,WF17 0,WF17 0,Total,8058,4008,4050,7982,76,73,474.25,17.0,-1.64057,53.7269,7852.0
3240,2011,WF17 5,WF17 5,Total,3378,1738,1640,3376,2,11,92.98,36.3,-1.63053,53.7125,3718.0
3241,2011,WF17 6,WF17 6,Total,7082,3555,3527,7020,62,32,298.23,23.7,-1.61976,53.7081,6866.0
3242,2011,WF17 7,WF17 7,Total,13043,6532,6511,12997,46,62,183.93,70.9,-1.64272,53.7084,12319.0
3243,2011,WF17 8,WF17 8,Total,6354,3146,3208,6354,0,34,171.94,37.0,-1.65012,53.7188,6664.0
3244,2011,WF17 9,WF17 9,Total,5804,2785,3019,5758,46,45,341.39,17.0,-1.66133,53.7323,5976.0
3245,2011,WR10 1,WR10 1,Total,6873,3340,3533,6809,64,71,880.53,7.8,-2.07802,52.1144,6758.0
3246,2011,WR10 2,WR10 2,Total,6009,2946,3063,5954,55,113,4608.98,1.3,-2.06179,52.1339,6231.0
3247,2011,WR10 3,WR10 3,Total,4844,2363,2481,4736,108,99,5808.91,0.8,-2.0612,52.0906,4757.0
3248,2011,WR11 1,WR11 1,Total,6851,3373,3478,6796,55,87,309.01,22.2,-1.93993,52.0846,6785.0
3249,2011,WR11 2,WR11 2,Total,6752,3296,3456,6742,10,74,1584.79,4.3,-1.95845,52.0839,6991.0
3250,2011,WR11 3,WR11 3,Total,4079,2018,2061,4051,28,49,262.46,15.5,-1.93378,52.0927,3986.0
3251,2011,WR11 4,WR11 4,Total,7947,3955,3992,7886,61,89,3849.74,2.1,-1.94933,52.1025,7717.0
3252,2011,WR11 7,WR11 7,Total,8478,4179,4299,8417,61,167,5969.22,1.4,-1.90873,52.0791,8389.0
3253,2011,WR11 8,WR11 8,Total,7507,3827,3680,7010,497,104,3597.26,2.1,-1.90816,52.1264,7732.0
3254,2011,WR12 7,WR12 7,Total,5436,2568,2868,5371,65,103,5990.21,0.9,-1.87947,52.047,5576.0
3255,2011,WR13 5,WR13 5,Total,3508,1736,1772,3469,39,89,4991.51,0.7,-2.35795,52.1301,3591.0
3256,2011,WR13 6,WR13 6,Total,4687,2237,2450,4497,190,137,5337.23,0.9,-2.32936,52.0681,4683.0
3257,2011,WR14 1,WR14 1,Total,11656,5625,6031,11566,90,150,946.54,12.3,-2.3236,52.1281,11688.0
3258,2011,WR14 2,WR14 2,Total,10989,5273,5716,10880,109,150,435.31,25.2,-2.31401,52.1154,10656.0
3259,2011,WR14 3,WR14 3,Total,6198,2883,3315,5325,873,115,523.44,11.8,-2.3153,52.1057,6396.0
3260,2011,WR14 4,WR14 4,Total,5364,2752,2612,5109,255,131,1397.61,3.8,-2.33399,52.0993,5550.0
3261,2011,WR15 8,WR15 8,Total,7098,3503,3595,6962,136,120,10371.61,0.7,-2.573,52.3063,7196.0
3262,2011,WS10 0,WS10 0,Total,14197,6838,7359,14197,0,63,343.14,41.4,-2.00202,52.5532,14384.0
3263,2011,WS10 7,WS10 7,Total,5930,2870,3060,5833,97,40,263.95,22.5,-2.03042,52.5556,5999.0
3264,2011,WS10 8,WS10 8,Total,12757,6344,6413,12662,95,50,356.62,35.8,-2.03841,52.5693,12505.0
3265,2011,WS10 9,WS10 9,Total,13827,6839,6988,13673,154,79,308.37,44.8,-2.01904,52.5613,13822.0
3266,2011,WS11 0,WS11 0,Total,4269,2085,2184,4186,83,20,218.48,19.5,-2.02923,52.6808,4031.0
3267,2011,WS11 1,WS11 1,Total,8801,4289,4512,8798,3,84,1079.54,8.2,-2.03971,52.6879,8921.0
3268,2011,WS11 4,WS11 4,Total,4475,2217,2258,4454,21,24,90.89,49.2,-2.03094,52.7035,4378.0
3269,2011,WS11 5,WS11 5,Total,7462,3659,3803,7431,31,44,178.26,41.9,-2.02113,52.7025,7208.0
3270,2011,WS11 6,WS11 6,Total,3927,1930,1997,3927,0,22,130.73,30.0,-2.01596,52.6977,4246.0
3271,2011,WS11 7,WS11 7,Total,4502,2153,2349,4388,114,46,109.33,41.2,-2.00503,52.6938,4942.0
3272,2011,WS11 8,WS11 8,Total,1678,824,854,1675,3,12,79.5,21.1,-2.01874,52.679,1560.0
3273,2011,WS11 9,WS11 9,Total,7479,3696,3783,7473,6,45,1515.92,4.9,-1.9786,52.6736,7394.0
3274,2011,WS12 0,WS12 0,Total,3360,1683,1677,3322,38,25,694.25,4.8,-1.97258,52.7082,3235.0
3275,2011,WS12 1,WS12 1,Total,4882,2479,2403,4864,18,34,274.19,17.8,-1.99712,52.7056,5165.0
3276,2011,WS12 2,WS12 2,Total,6544,3266,3278,6453,91,67,155.91,42.0,-1.98912,52.6969,6787.0
3277,2011,WS12 3,WS12 3,Total,5043,2515,2528,4994,49,43,170.54,29.6,-1.99504,52.6899,4466.0
3278,2011,WS12 4,WS12 4,Total,15579,7768,7811,15537,42,108,1844.74,8.4,-2.01935,52.7142,15455.0
3279,2011,WS13 6,WS13 6,Total,8824,4311,4513,8630,194,104,283.44,31.1,-1.82148,52.6842,8434.0
3280,2011,WS13 7,WS13 7,Total,10948,5382,5566,10921,27,114,336.88,32.5,-1.82965,52.6918,11048.0
3281,2011,WS13 8,WS13 8,Total,6856,3334,3522,6748,108,126,5204.68,1.3,-1.80511,52.6984,6893.0
3282,2011,WS14 0,WS14 0,Total,4466,2149,2317,4335,131,76,3517.05,1.3,-1.83979,52.6475,4582.0
3283,2011,WS14 9,WS14 9,Total,12639,6599,6040,11976,663,306,1698.88,7.4,-1.80107,52.6754,13070.0
3284,2011,WS15 1,WS15 1,Total,10108,4946,5162,10078,30,72,719.39,14.1,-1.92719,52.7486,10533.0
3285,2011,WS15 2,WS15 2,Total,14776,7311,7465,14593,183,103,1970.73,7.5,-1.9457,52.7623,14525.0
3286,2011,WS15 3,WS15 3,Total,4121,2022,2099,4021,100,102,8643.19,0.5,-1.89264,52.7914,4325.0
3287,2011,WS15 4,WS15 4,Total,7547,3691,3856,7435,112,90,2706.08,2.8,-1.89273,52.7327,7228.0
3288,2011,WV10 0,WV10 0,Total,11309,5761,5548,11309,0,85,266.95,42.4,-2.10953,52.5947,11250.0
3289,2011,WV10 6,WV10 6,Total,11675,5612,6063,11628,47,85,434.22,26.9,-2.12947,52.6167,12179.0
3290,2011,WV10 7,WV10 7,Total,7013,3821,3192,6197,816,63,2554.59,2.7,-2.10178,52.6464,7111.0
3291,2011,WV10 8,WV10 8,Total,11952,5729,6223,11881,71,71,419.83,28.5,-2.10813,52.6197,11893.0
3292,2011,WV10 9,WV10 9,Total,14445,6852,7593,14332,113,63,330.11,43.8,-2.11604,52.607,13859.0
3293,2011,WV11 1,WV11 1,Total,11937,5880,6057,11786,151,78,280.89,42.5,-2.08744,52.606,11930.0
3294,2011,WV11 2,WV11 2,Total,10838,5337,5501,10811,27,80,1246.21,8.7,-2.05782,52.6211,11039.0
3295,2011,WV11 3,WV11 3,Total,11796,5857,5939,11738,58,61,391.93,30.1,-2.06904,52.6038,11863.0
3296,2011,WV12 4,WV12 4,Total,10413,5130,5283,10413,0,57,295.1,35.3,-2.04297,52.599,10054.0
3297,2011,WV12 5,WV12 5,Total,15236,7470,7766,15182,54,99,345.9,44.0,-2.04109,52.6108,15363.0
3298,2011,WV13 1,WV13 1,Total,5808,2810,2998,5774,34,26,125.26,46.4,-2.0551,52.5883,6091.0
3299,2011,WV13 2,WV13 2,Total,7124,3539,3585,7064,60,37,262.38,27.2,-2.05465,52.5832,6665.0
3300,2011,WV13 3,WV13 3,Total,7706,3766,3940,7706,0,40,185.53,41.5,-2.07707,52.5851,8147.0
3301,2011,WV14 0,WV14 0,Total,5950,2985,2965,5868,82,29,312.73,19.0,-2.07898,52.5624,5621.0
3302,2011,WV14 6,WV14 6,Total,8637,4267,4370,8582,55,39,199.3,43.3,-2.0779,52.5719,8848.0
3303,2011,WV14 7,WV14 7,Total,4361,2126,2235,4361,0,21,136.05,32.1,-2.06544,52.5669,4277.0
3304,2011,WV14 8,WV14 8,Total,14386,7020,7366,14369,17,55,356.09,40.4,-2.06934,52.5517,14797.0
3305,2011,WV14 9,WV14 9,Total,13835,6751,7084,13704,131,90,366.64,37.7,-2.09491,52.5465,13394.0
3306,2011,WV15 5,WV15 5,Total,3753,1864,1889,3665,88,66,3133.98,1.2,-2.38831,52.5428,4203.0
3307,2011,WV15 6,WV15 6,Total,4186,2077,2109,4089,97,66,4232.66,1.0,-2.37203,52.4931,4212.0
3308,2011,WV16 4,WV16 4,Total,7112,3500,3612,7043,69,121,3280.7,2.2,-2.43063,52.5408,7004.0
3309,2011,WV16 5,WV16 5,Total,3360,1633,1727,3315,45,60,1204.77,2.8,-2.4297,52.5298,3479.0
3310,2011,WV16 6,WV16 6,Total,6818,3356,3462,6732,86,95,14251.23,0.5,-2.45276,52.4779,7151.0
3311,2011,YO10 3,YO10 3,Total,12864,6429,6435,12784,80,108,391.23,32.9,-1.05366,53.956,13426.0
3312,2011,YO10 4,YO10 4,Total,9027,4576,4451,8544,483,123,311.08,29.0,-1.07549,53.9465,8746.0
3313,2011,YO10 5,YO10 5,Total,8602,4063,4539,4675,3927,107,1344.04,6.4,-1.05314,53.9499,8371.0
3314,2011,YO11 1,YO11 1,Total,3970,2021,1949,3867,103,20,85.48,46.4,-0.400919,54.2835,4240.0
3315,2011,YO11 2,YO11 2,Total,7468,3674,3794,6786,682,75,281.35,26.5,-0.402184,54.2747,7504.0
3316,2011,YO11 3,YO11 3,Total,11461,5503,5958,11222,239,99,4381.84,2.6,-0.391588,54.2445,11455.0
3317,2011,YO12 4,YO12 4,Total,9023,4417,4606,8867,156,109,5639.85,1.6,-0.430322,54.2436,9115.0
3318,2011,YO12 5,YO12 5,Total,9707,4592,5115,9555,152,139,555.08,17.5,-0.427414,54.2813,9261.0
3319,2011,YO12 6,YO12 6,Total,10678,5065,5613,10564,114,124,320.97,33.3,-0.423356,54.2919,11238.0
3320,2011,YO12 7,YO12 7,Total,11436,5600,5836,11170,266,129,158.41,72.2,-0.40838,54.2845,11135.0
3321,2011,YO13 0,YO13 0,Total,5166,2482,2684,5113,53,103,12066.68,0.4,-0.461412,54.3219,4943.0
3322,2011,YO13 9,YO13 9,Total,4945,2343,2602,4917,28,108,10578.0,0.5,-0.534918,54.241,4980.0
3323,2011,YO14 0,YO14 0,Total,5499,2600,2899,5497,2,59,3424.69,1.6,-0.309679,54.195,5631.0
3324,2011,YO14 9,YO14 9,Total,5757,2750,3007,5754,3,54,2632.81,2.2,-0.28945,54.2018,5663.0
3325,2011,YO15 1,YO15 1,Total,3416,1654,1762,3400,16,40,3330.41,1.0,-0.144849,54.117,3493.0
3326,2011,YO15 2,YO15 2,Total,4695,2395,2300,4337,358,36,81.55,57.6,-0.190062,54.0855,4798.0
3327,2011,YO15 3,YO15 3,Total,5628,2728,2900,5330,298,58,240.5,23.4,-0.20515,54.0773,5794.0
3328,2011,YO16 4,YO16 4,Total,9530,4549,4981,9357,173,58,4650.29,2.0,-0.21314,54.0888,9299.0
3329,2011,YO16 6,YO16 6,Total,7536,3584,3952,7481,55,68,639.44,11.8,-0.186726,54.1032,6979.0
3330,2011,YO16 7,YO16 7,Total,8409,4001,4408,8351,58,67,485.77,17.3,-0.199953,54.0953,8831.0
3331,2011,YO17 6,YO17 6,Total,2783,1379,1404,2761,22,55,8667.12,0.3,-0.823182,54.1645,2995.0
3332,2011,YO17 7,YO17 7,Total,4888,2412,2476,4781,107,72,1625.08,3.0,-0.798255,54.1376,4734.0
3333,2011,YO17 8,YO17 8,Total,5763,2843,2920,5704,59,78,20154.26,0.3,-0.649399,54.1486,5856.0
3334,2011,YO17 9,YO17 9,Total,7780,3825,3955,7716,64,77,11485.79,0.7,-0.778482,54.1082,7663.0
3335,2011,YO18 7,YO18 7,Total,5451,2533,2918,5350,101,91,13935.94,0.4,-0.740974,54.2441,5398.0
3336,2011,YO18 8,YO18 8,Total,5309,2563,2746,5265,44,75,12852.82,0.4,-0.799732,54.2712,5472.0
3337,2011,YO19 4,YO19 4,Total,1464,715,749,1447,17,20,1551.16,0.9,-1.06924,53.9214,1524.0
3338,2011,YO19 5,YO19 5,Total,4410,2123,2287,4356,54,90,2317.42,1.9,-0.998725,53.9652,4266.0
3339,2011,YO19 6,YO19 6,Total,7040,3319,3721,6730,310,137,8462.78,0.8,-1.0352,53.8723,6950.0
3340,2011,YO21 1,YO21 1,Total,5938,2855,3083,5893,45,82,7310.82,0.8,-0.640746,54.4773,6159.0
3341,2011,YO21 2,YO21 2,Total,3079,1530,1549,3066,13,77,19402.3,0.2,-0.89369,54.4609,3117.0
3342,2011,YO21 3,YO21 3,Total,5115,2456,2659,4854,261,52,2135.96,2.4,-0.637242,54.4899,5139.0
3343,2011,YO22 4,YO22 4,Total,5852,2912,2940,5634,218,78,6972.11,0.8,-0.584231,54.4611,5645.0
3344,2011,YO22 5,YO22 5,Total,2876,1367,1509,2852,24,42,8417.89,0.3,-0.68741,54.4368,2893.0
3345,2011,YO23 1,YO23 1,Total,8253,4018,4235,8222,31,88,313.27,26.3,-1.08806,53.95,8276.0
3346,2011,YO23 2,YO23 2,Total,3906,1878,2028,3895,11,87,1152.83,3.4,-1.10209,53.9178,3919.0
3347,2011,YO23 3,YO23 3,Total,6069,2919,3150,5758,311,154,3683.94,1.6,-1.14737,53.9277,6097.0
3348,2011,YO23 7,YO23 7,Total,1096,546,550,1096,0,26,2746.22,0.4,-1.1663,53.8762,1097.0
3349,2011,YO24 1,YO24 1,Total,5533,2652,2881,5371,162,91,226.94,24.4,-1.1028,53.9446,5420.0
3350,2011,YO24 2,YO24 2,Total,7515,3654,3861,7514,1,95,260.55,28.8,-1.12095,53.9406,7489.0
3351,2011,YO24 3,YO24 3,Total,8686,4145,4541,8614,72,64,170.56,50.9,-1.1272,53.9483,8844.0
3352,2011,YO24 4,YO24 4,Total,7922,3901,4021,7778,144,91,168.17,47.1,-1.10848,53.9539,7918.0
3353,2011,YO25 3,YO25 3,Total,2436,1208,1228,2420,16,42,16277.49,0.1,-0.451997,54.0969,2386.0
3354,2011,YO25 4,YO25 4,Total,4730,2286,2444,4716,14,60,12781.07,0.4,-0.369267,54.0473,4564.0
3355,2011,YO25 5,YO25 5,Total,7013,3341,3672,6857,156,103,769.52,9.1,-0.437086,54.0089,7363.0
3356,2011,YO25 6,YO25 6,Total,6067,2940,3127,6016,51,64,230.25,26.3,-0.440588,54.0034,5733.0
3357,2011,YO25 8,YO25 8,Total,5950,2984,2966,5926,24,85,15669.6,0.4,-0.300413,53.9674,5906.0
3358,2011,YO25 9,YO25 9,Total,7114,3471,3643,7064,50,144,19079.2,0.4,-0.504584,53.9661,7476.0
3359,2011,YO26 4,YO26 4,Total,6090,2992,3098,6090,0,52,141.83,42.9,-1.10814,53.9606,5985.0
3360,2011,YO26 5,YO26 5,Total,11758,5786,5972,11657,101,106,254.16,46.3,-1.12807,53.9602,11904.0
3361,2011,YO26 6,YO26 6,Total,5445,2570,2875,5424,21,118,1253.31,4.3,-1.13798,53.9761,5469.0
3362,2011,YO26 7,YO26 7,Total,2092,1038,1054,2092,0,47,3017.75,0.7,-1.2325,53.9592,2203.0
3363,2011,YO26 8,YO26 8,Total,2938,1445,1493,2843,95,66,4641.53,0.6,-1.27327,53.9992,3117.0
3364,2011,YO26 9,YO26 9,Total,1879,940,939,1300,579,74,3359.56,0.6,-1.31316,54.0472,1778.0
3365,2011,YO30 1,YO30 1,Total,2421,1180,1241,2375,46,57,2775.67,0.9,-1.14181,54.0072,2393.0
3366,2011,YO30 2,YO30 2,Total,1800,966,834,1635,165,25,1639.48,1.1,-1.21012,54.0298,1735.0
3367,2011,YO30 4,YO30 4,Total,2846,1397,1449,2846,0,50,294.63,9.7,-1.09846,53.9824,2791.0
3368,2011,YO30 5,YO30 5,Total,7543,3660,3883,7408,135,92,369.72,20.4,-1.10535,53.9811,7677.0
3369,2011,YO30 6,YO30 6,Total,9602,4702,4900,9414,188,105,185.24,51.8,-1.09304,53.9724,9444.0
3370,2011,YO30 7,YO30 7,Total,2399,1227,1172,2247,152,43,68.27,35.1,-1.08684,53.9666,2683.0
3371,2011,YO31 0,YO31 0,Total,6592,3266,3326,6575,17,61,138.74,47.5,-1.05566,53.9639,6755.0
3372,2011,YO31 1,YO31 1,Total,4632,2244,2388,4621,11,74,406.86,11.4,-1.0545,53.9704,4475.0
3373,2011,YO31 7,YO31 7,Total,5294,2712,2582,5021,273,61,93.98,56.3,-1.07379,53.9658,5047.0
3374,2011,YO31 8,YO31 8,Total,7104,3320,3784,6598,506,69,119.26,59.6,-1.07587,53.9708,6843.0
3375,2011,YO31 9,YO31 9,Total,6617,3187,3430,6610,7,77,145.75,45.4,-1.06563,53.9803,6485.0
3376,2011,YO32 2,YO32 2,Total,5195,2384,2811,5097,98,84,792.56,6.6,-1.08379,54.0126,5662.0
3377,2011,YO32 3,YO32 3,Total,6843,3240,3603,6786,57,123,862.03,7.9,-1.07265,54.0104,6535.0
3378,2011,YO32 4,YO32 4,Total,2737,1205,1532,2667,70,17,317.2,8.6,-1.07321,53.9911,2659.0
3379,2011,YO32 5,YO32 5,Total,6047,2928,3119,5896,151,140,1609.34,3.8,-1.03785,54.0341,6068.0
3380,2011,YO32 9,YO32 9,Total,7448,3602,3846,7374,74,119,2429.7,3.1,-1.04891,53.9928,7644.0
3381,2011,YO41 1,YO41 1,Total,6011,3199,2812,5331,680,101,7356.06,0.8,-0.906684,53.9932,6094.0
3382,2011,YO41 4,YO41 4,Total,2148,1053,1095,2148,0,48,3142.84,0.7,-0.957574,53.9281,2104.0
3383,2011,YO41 5,YO41 5,Total,2678,1320,1358,2660,18,44,3033.09,0.9,-0.877667,53.9545,2765.0
3384,2011,YO42 1,YO42 1,Total,2093,1036,1057,2077,16,50,13959.73,0.1,-0.749091,53.95,2110.0
3385,2011,YO42 2,YO42 2,Total,8337,4011,4326,8161,176,134,1060.99,7.9,-0.778451,53.9309,8186.0
3386,2011,YO42 4,YO42 4,Total,4129,2067,2062,4116,13,104,10783.21,0.4,-0.835574,53.8955,4155.0
3387,2011,YO43 3,YO43 3,Total,7358,3569,3789,7300,58,88,5920.97,1.2,-0.670696,53.8674,7310.0
3388,2011,YO43 4,YO43 4,Total,4930,2426,2504,4891,39,63,10892.9,0.5,-0.700738,53.8309,5001.0
3389,2011,YO51 9,YO51 9,Total,5533,2688,2845,5435,98,94,4480.5,1.2,-1.38864,54.088,5543.0
3390,2011,YO60 6,YO60 6,Total,1636,785,851,1628,8,47,5270.93,0.3,-1.00022,54.0992,1551.0
3391,2011,YO60 7,YO60 7,Total,3105,1543,1562,3105,0,80,10361.99,0.3,-0.921362,54.0773,3032.0
3392,2011,YO61 1,YO61 1,Total,5216,2540,2676,5154,62,143,9817.25,0.5,-1.1706,54.0872,5162.0
3393,2011,YO61 2,YO61 2,Total,1222,639,583,1183,39,33,4364.39,0.3,-1.33147,54.1257,1282.0
3394,2011,YO61 3,YO61 3,Total,5295,2456,2839,5273,22,122,5616.76,0.9,-1.20077,54.1249,5361.0
3395,2011,YO61 4,YO61 4,Total,2271,1116,1155,2237,34,67,11485.62,0.2,-1.16902,54.1681,2109.0
3396,2011,YO62 4,YO62 4,Total,2952,1600,1352,2304,648,97,6871.43,0.4,-1.02979,54.1794,3065.0
3397,2011,YO62 5,YO62 5,Total,2803,1368,1435,2791,12,64,20030.63,0.1,-1.06495,54.2453,2717.0
3398,2011,YO62 6,YO62 6,Total,4444,2156,2288,4430,14,70,10943.26,0.4,-0.919128,54.2667,4312.0
3399,2011,YO62 7,YO62 7,Total,1861,937,924,1833,28,39,13739.59,0.1,-0.979164,54.2816,1885.0
3400,2011,CF10 1,CF10 1,Total,802,494,308,801,1,3,136.37,5.9,-3.18211,51.4762,869.0
3401,2011,CF10 2,CF10 2,Total,1727,1054,673,1727,0,17,41.96,41.2,-3.17726,51.4781,1348.0
3402,2011,CF10 3,CF10 3,Total,1962,901,1061,999,963,26,22.56,87.0,-3.18347,51.4791,2095.0
3403,2011,CF10 4,CF10 4,Total,4064,2310,1754,4064,0,15,293.91,13.8,-3.16807,51.4698,5227.0
3404,2011,CF10 5,CF10 5,Total,6061,3231,2830,5873,188,22,218.29,27.8,-3.17547,51.4673,5926.0
3405,2011,CF11 0,CF11 0,Total,2253,1247,1006,2253,0,11,140.06,16.1,-3.18501,51.4535,2223.0
3406,2011,CF11 6,CF11 6,Total,12248,6488,5760,11927,321,65,206.39,59.3,-3.19035,51.4747,12284.0
3407,2011,CF11 7,CF11 7,Total,9896,5043,4853,9848,48,50,101.35,97.6,-3.18479,51.4643,9790.0
3408,2011,CF11 8,CF11 8,Total,3904,1910,1994,3904,0,16,201.57,19.4,-3.20215,51.4701,4070.0
3409,2011,CF11 9,CF11 9,Total,7757,3915,3842,7497,260,80,204.74,37.9,-3.19673,51.4814,7780.0
3410,2011,CF14 0,CF14 0,Total,5349,2636,2713,5349,0,152,878.48,6.1,-3.17854,51.5349,5623.0
3411,2011,CF14 1,CF14 1,Total,10205,4869,5336,9961,244,144,209.8,48.6,-3.21158,51.5128,9647.0
3412,2011,CF14 2,CF14 2,Total,10875,5229,5646,10790,85,114,294.42,36.9,-3.22081,51.5083,10714.0
3413,2011,CF14 3,CF14 3,Total,11994,5643,6351,9156,2838,173,262.55,45.7,-3.19249,51.5056,11561.0
3414,2011,CF14 4,CF14 4,Total,9253,4542,4711,9245,8,134,173.76,53.3,-3.1956,51.5159,9903.0
3415,2011,CF14 5,CF14 5,Total,9547,4562,4985,9367,180,121,252.23,37.9,-3.19278,51.5274,8830.0
3416,2011,CF14 6,CF14 6,Total,9007,4239,4768,9007,0,139,537.67,16.8,-3.211,51.5258,9369.0
3417,2011,CF14 7,CF14 7,Total,4627,2266,2361,4597,30,83,238.39,19.4,-3.22737,51.5221,4811.0
3418,2011,CF14 9,CF14 9,Total,6999,3334,3665,6999,0,157,156.82,44.6,-3.19506,51.5368,7308.0
3419,2011,CF15 7,CF15 7,Total,5543,2670,2873,5465,78,54,1101.14,5.0,-3.26218,51.5462,5585.0
3420,2011,CF15 8,CF15 8,Total,6417,3142,3275,6379,38,173,466.91,13.7,-3.25939,51.52,6424.0
3421,2011,CF15 9,CF15 9,Total,5863,2857,3006,5844,19,189,1424.48,4.1,-3.2963,51.5322,5978.0
3422,2011,CF23 5,CF23 5,Total,10199,4933,5266,9419,780,206,219.92,46.4,-3.1549,51.5042,10390.0
3423,2011,CF23 6,CF23 6,Total,10743,5201,5542,9964,779,285,321.17,33.4,-3.16062,51.5179,10511.0
3424,2011,CF23 7,CF23 7,Total,8038,3795,4243,7930,108,79,148.56,54.1,-3.14177,51.5238,8101.0
3425,2011,CF23 8,CF23 8,Total,7353,3524,3829,7353,0,87,516.89,14.2,-3.13164,51.5307,7273.0
3426,2011,CF23 9,CF23 9,Total,10694,5105,5589,10694,0,100,354.08,30.2,-3.14691,51.5067,10713.0
3427,2011,CF24 0,CF24 0,Total,5420,2948,2472,3742,1678,46,58.11,93.3,-3.17327,51.4779,4098.0
3428,2011,CF24 1,CF24 1,Total,5618,2974,2644,5371,247,33,85.92,65.4,-3.1581,51.4862,5726.0
3429,2011,CF24 2,CF24 2,Total,12926,6308,6618,12875,51,75,390.22,33.1,-3.15094,51.4836,12771.0
3430,2011,CF24 3,CF24 3,Total,11490,6272,5218,11319,171,94,98.08,117.1,-3.17103,51.4861,11927.0
3431,2011,CF24 4,CF24 4,Total,20071,10122,9949,18675,1396,162,164.89,121.7,-3.17884,51.4918,19978.0
3432,2011,CF24 5,CF24 5,Total,335,153,182,335,0,1,98.2,3.4,-3.15683,51.4759,663.0
3433,2011,CF31 1,CF31 1,Total,9200,4520,4680,9136,64,91,304.33,30.2,-3.57637,51.5132,9151.0
3434,2011,CF31 2,CF31 2,Total,11749,5756,5993,11708,41,164,321.41,36.6,-3.55814,51.5099,11672.0
3435,2011,CF31 3,CF31 3,Total,4298,2110,2188,4187,111,102,357.8,12.0,-3.56451,51.4997,4407.0
3436,2011,CF31 4,CF31 4,Total,13438,6529,6909,13290,148,188,796.77,16.9,-3.59251,51.5127,13623.0
3437,2011,CF31 5,CF31 5,Total,6198,3046,3152,6198,0,89,145.98,42.5,-3.59864,51.5018,5976.0
3438,2011,CF32 0,CF32 0,Total,4946,2401,2545,4946,0,98,5682.19,0.9,-3.61748,51.5025,5069.0
3439,2011,CF32 7,CF32 7,Total,6195,3019,3176,6195,0,29,2439.34,2.5,-3.54204,51.6044,6193.0
3440,2011,CF32 8,CF32 8,Total,7784,3869,3915,7784,0,62,3089.87,2.5,-3.58368,51.5909,7873.0
3441,2011,CF32 9,CF32 9,Total,10980,5400,5580,10931,49,82,1563.26,7.0,-3.5828,51.5425,10796.0
3442,2011,CF33 4,CF33 4,Total,7059,3412,3647,6992,67,56,1661.31,4.2,-3.69746,51.519,7087.0
3443,2011,CF33 6,CF33 6,Total,7405,3665,3740,7391,14,58,323.16,22.9,-3.67738,51.5296,7558.0
3444,2011,CF34 0,CF34 0,Total,10932,5343,5589,10930,2,61,1976.12,5.5,-3.65157,51.6197,10897.0
3445,2011,CF34 9,CF34 9,Total,9680,4782,4898,9679,1,89,2095.78,4.6,-3.65348,51.6017,9719.0
3446,2011,CF35 5,CF35 5,Total,5609,2741,2868,5491,118,82,2833.85,2.0,-3.52645,51.5049,5601.0
3447,2011,CF35 6,CF35 6,Total,10543,5986,4557,9165,1378,90,4162.87,2.5,-3.52898,51.5308,10755.0
3448,2011,CF36 3,CF36 3,Total,9009,4261,4748,8801,208,159,701.17,12.8,-3.7085,51.4848,8980.0
3449,2011,CF36 5,CF36 5,Total,6996,3369,3627,6861,135,99,637.62,11.0,-3.68652,51.4842,6863.0
3450,2011,CF37 1,CF37 1,Total,10318,5393,4925,9471,847,133,983.87,10.5,-3.34026,51.5956,10100.0
3451,2011,CF37 2,CF37 2,Total,5515,2688,2827,5490,25,44,941.71,5.9,-3.3525,51.606,5561.0
3452,2011,CF37 3,CF37 3,Total,7523,3671,3852,7523,0,71,2164.52,3.5,-3.34957,51.6305,7554.0
3453,2011,CF37 4,CF37 4,Total,6874,3331,3543,6801,73,53,779.39,8.8,-3.32976,51.6087,6945.0
3454,2011,CF37 5,CF37 5,Total,8093,3888,4205,8062,31,41,823.48,9.8,-3.30383,51.5813,8169.0
3455,2011,CF38 1,CF38 1,Total,9923,4833,5090,9863,60,94,1283.48,7.7,-3.31909,51.5666,9835.0
3456,2011,CF38 2,CF38 2,Total,13354,6531,6823,13337,17,130,917.42,14.6,-3.34609,51.5559,13253.0
3457,2011,CF39 0,CF39 0,Total,5521,2697,2824,5428,93,46,558.71,9.9,-3.41486,51.6239,5350.0
3458,2011,CF39 8,CF39 8,Total,15268,7433,7835,15116,152,109,3059.89,5.0,-3.44351,51.5849,15134.0
3459,2011,CF39 9,CF39 9,Total,8137,4002,4135,8105,32,46,582.74,14.0,-3.41209,51.61,8384.0
3460,2011,CF40 1,CF40 1,Total,9475,4714,4761,9424,51,59,1087.44,8.7,-3.44649,51.6134,9341.0
3461,2011,CF40 2,CF40 2,Total,11113,5411,5702,11011,102,58,1090.55,10.2,-3.45583,51.6266,11200.0
3462,2011,CF41 7,CF41 7,Total,10755,5242,5513,10601,154,67,1278.16,8.4,-3.48273,51.6478,10724.0
3463,2011,CF42 5,CF42 5,Total,6047,2961,3086,5999,48,36,2164.43,2.8,-3.53902,51.6759,6037.0
3464,2011,CF42 6,CF42 6,Total,7374,3592,3782,7261,113,71,1319.51,5.6,-3.50953,51.6596,7386.0
3465,2011,CF43 3,CF43 3,Total,4546,2227,2319,4536,10,20,589.0,7.7,-3.4351,51.6447,4546.0
3466,2011,CF43 4,CF43 4,Total,7338,3592,3746,7300,38,25,1442.62,5.1,-3.46011,51.666,7338.0
3467,2011,CF44 0,CF44 0,Total,7817,3797,4020,7771,46,66,6367.93,1.2,-3.43467,51.7181,7691.0
3468,2011,CF44 6,CF44 6,Total,9865,4845,5020,9798,67,65,1685.57,5.9,-3.43034,51.6964,9948.0
3469,2011,CF44 7,CF44 7,Total,3662,1748,1914,3616,46,34,138.5,26.4,-3.44574,51.7118,3745.0
3470,2011,CF44 8,CF44 8,Total,9043,4389,4654,8852,191,91,1386.81,6.5,-3.46006,51.7181,8825.0
3471,2011,CF44 9,CF44 9,Total,8824,4285,4539,8813,11,62,11917.75,0.7,-3.50992,51.7397,8978.0
3472,2011,CF45 3,CF45 3,Total,10254,4922,5332,10151,103,61,564.05,18.2,-3.37599,51.6768,10254.0
3473,2011,CF45 4,CF45 4,Total,9299,4543,4756,9261,38,63,1765.92,5.3,-3.35027,51.6637,9296.0
3474,2011,CF46 5,CF46 5,Total,6356,3119,3237,6313,43,77,807.74,7.9,-3.3096,51.6622,6367.0
3475,2011,CF46 6,CF46 6,Total,7924,3890,4034,7858,66,65,2620.09,3.0,-3.29486,51.6654,7924.0
3476,2011,CF47 0,CF47 0,Total,7551,3794,3757,7492,59,68,750.83,10.1,-3.37094,51.7448,7531.0
3477,2011,CF47 8,CF47 8,Total,3215,1598,1617,3160,55,26,176.41,18.2,-3.38065,51.749,3703.0
3478,2011,CF47 9,CF47 9,Total,11120,5316,5804,11086,34,74,243.35,45.7,-3.37443,51.7603,10740.0
3479,2011,CF48 1,CF48 1,Total,8997,4381,4616,8943,54,83,914.65,9.8,-3.39579,51.7446,8659.0
3480,2011,CF48 2,CF48 2,Total,6207,3016,3191,6160,47,40,3593.79,1.7,-3.38129,51.7702,6236.0
3481,2011,CF48 3,CF48 3,Total,4270,2115,2155,4246,24,22,331.5,12.9,-3.35433,51.7624,4291.0
3482,2011,CF48 4,CF48 4,Total,7809,3825,3984,7668,141,67,2799.56,2.8,-3.34671,51.7077,7991.0
3483,2011,CF61 1,CF61 1,Total,4798,2291,2507,4459,339,84,1658.63,2.9,-3.48479,51.4076,5017.0
3484,2011,CF61 2,CF61 2,Total,5185,2509,2676,5184,1,70,1634.49,3.2,-3.47475,51.4124,4755.0
3485,2011,CF62 3,CF62 3,Total,6907,3391,3516,6901,6,101,4313.93,1.6,-3.34999,51.397,6790.0
3486,2011,CF62 4,CF62 4,Total,5133,2905,2228,4413,720,49,1327.93,3.9,-3.41471,51.4068,5287.0
3487,2011,CF62 5,CF62 5,Total,2658,1277,1381,2614,44,21,168.63,15.8,-3.27384,51.396,2862.0
3488,2011,CF62 6,CF62 6,Total,5802,2771,3031,5730,72,100,232.58,24.9,-3.29205,51.3971,5852.0
3489,2011,CF62 7,CF62 7,Total,7271,3531,3740,7255,16,100,232.31,31.3,-3.28488,51.404,6710.0
3490,2011,CF62 8,CF62 8,Total,7265,3465,3800,7034,231,56,341.47,21.3,-3.28009,51.41,7387.0
3491,2011,CF62 9,CF62 9,Total,6410,3010,3400,6403,7,60,196.9,32.6,-3.27156,51.4185,6831.0
3492,2011,CF63 1,CF63 1,Total,9265,4413,4852,9229,36,61,215.28,43.0,-3.25851,51.4169,8913.0
3493,2011,CF63 2,CF63 2,Total,5437,2718,2719,5429,8,33,190.61,28.5,-3.24757,51.4142,5504.0
3494,2011,CF63 3,CF63 3,Total,1404,700,704,1404,0,11,19.99,70.2,-3.25621,51.4058,1490.0
3495,2011,CF63 4,CF63 4,Total,5818,2864,2954,5810,8,31,221.99,26.2,-3.26616,51.4049,5827.0
3496,2011,CF64 1,CF64 1,Total,5355,2758,2597,5317,38,71,112.41,47.6,-3.175,51.4415,5646.0
3497,2011,CF64 2,CF64 2,Total,8190,3895,4295,8068,122,102,322.43,25.4,-3.18759,51.441,8558.0
3498,2011,CF64 3,CF64 3,Total,8460,4012,4448,8369,91,165,322.38,26.2,-3.18135,51.4324,8455.0
3499,2011,CF64 4,CF64 4,Total,7799,3722,4077,7751,48,117,1959.82,4.0,-3.20817,51.4353,7591.0
3500,2011,CF64 5,CF64 5,Total,6770,3249,3521,6570,200,154,859.25,7.9,-3.19804,51.4157,6098.0
3501,2011,CF71 7,CF71 7,Total,9049,4457,4592,8986,63,281,10029.36,0.9,-3.45885,51.4599,8906.0
3502,2011,CF72 8,CF72 8,Total,10908,5301,5607,10822,86,129,1946.3,5.6,-3.37693,51.5328,11187.0
3503,2011,CF72 9,CF72 9,Total,14649,7153,7496,14636,13,180,2960.79,4.9,-3.42234,51.5271,14923.0
3504,2011,CF81 8,CF81 8,Total,8258,4066,4192,8199,59,45,375.05,22.0,-3.23232,51.6858,8182.0
3505,2011,CF81 9,CF81 9,Total,8173,4049,4124,8117,56,50,2549.45,3.2,-3.25357,51.7115,8147.0
3506,2011,CF82 6,CF82 6,Total,835,401,434,835,0,12,61.66,13.5,-3.24226,51.6542,772.0
3507,2011,CF82 7,CF82 7,Total,13377,6569,6808,13282,95,116,1663.32,8.0,-3.23385,51.6457,12978.0
3508,2011,CF82 8,CF82 8,Total,6021,2927,3094,6014,7,38,1031.72,5.8,-3.24298,51.6638,6412.0
3509,2011,CF83 1,CF83 1,Total,12523,6097,6426,12449,74,110,947.97,13.2,-3.22425,51.5729,12625.0
3510,2011,CF83 2,CF83 2,Total,12869,6328,6541,12816,53,133,583.38,22.1,-3.23843,51.5833,12488.0
3511,2011,CF83 3,CF83 3,Total,12293,5994,6299,12290,3,100,1906.05,6.4,-3.21672,51.5897,12451.0
3512,2011,CF83 4,CF83 4,Total,6799,3377,3422,6778,21,54,1331.5,5.1,-3.27237,51.6012,6795.0
3513,2011,CF83 8,CF83 8,Total,10758,5239,5519,10712,46,112,1832.51,5.9,-3.17871,51.5929,10945.0
3514,2011,LL11 1,LL11 1,Total,699,342,357,619,80,6,30.96,22.6,-2.99599,53.0419,505.0
3515,2011,LL11 2,LL11 2,Total,7581,3815,3766,7280,301,75,265.84,28.5,-2.99821,53.0582,7548.0
3516,2011,LL11 3,LL11 3,Total,7063,3537,3526,7008,55,62,5837.46,1.2,-3.07807,53.0542,6921.0
3517,2011,LL11 4,LL11 4,Total,9276,4598,4678,9018,258,72,683.83,13.6,-3.01743,53.0712,9391.0
3518,2011,LL11 5,LL11 5,Total,6878,3401,3477,6804,74,74,3093.22,2.2,-3.06081,53.0727,6927.0
3519,2011,LL11 6,LL11 6,Total,6840,3370,3470,6805,35,51,371.05,18.4,-3.03283,53.0633,6738.0
3520,2011,LL12 0,LL12 0,Total,8045,4007,4038,7983,62,115,3461.58,2.3,-2.97589,53.0993,7880.0
3521,2011,LL12 7,LL12 7,Total,7428,3556,3872,7418,10,59,214.97,34.6,-2.98175,53.0575,7402.0
3522,2011,LL12 8,LL12 8,Total,7707,3724,3983,7605,102,140,973.32,7.9,-2.97481,53.0797,7857.0
3523,2011,LL12 9,LL12 9,Total,5146,2536,2610,5029,117,67,1512.89,3.4,-3.03262,53.1045,5207.0
3524,2011,LL13 0,LL13 0,Total,7979,3995,3984,7966,13,143,9563.6,0.8,-2.93994,53.0056,7946.0
3525,2011,LL13 7,LL13 7,Total,7956,4157,3799,7771,185,106,288.64,27.6,-2.99775,53.0413,8114.0
3526,2011,LL13 8,LL13 8,Total,8042,4093,3949,7987,55,24,174.75,46.0,-2.98363,53.0433,8276.0
3527,2011,LL13 9,LL13 9,Total,10888,5392,5496,10792,96,119,3520.08,3.1,-2.9458,53.0553,10552.0
3528,2011,LL14 1,LL14 1,Total,4722,2352,2370,4715,7,43,139.77,33.8,-3.05274,53.0122,5096.0
3529,2011,LL14 2,LL14 2,Total,8361,4099,4262,8275,86,71,2379.43,3.5,-3.05421,53.0063,8230.0
3530,2011,LL14 3,LL14 3,Total,7051,3511,3540,6992,59,48,804.19,8.8,-3.06951,52.9786,7065.0
3531,2011,LL14 4,LL14 4,Total,4135,2079,2056,4099,36,37,1709.64,2.4,-3.03008,53.0331,3908.0
3532,2011,LL14 5,LL14 5,Total,5031,2431,2600,5002,29,49,2064.98,2.4,-3.05989,52.9398,5064.0
3533,2011,LL14 6,LL14 6,Total,4124,2030,2094,4095,29,33,1741.46,2.4,-3.03593,52.9902,4254.0
3534,2011,LL15 1,LL15 1,Total,7312,3587,3725,7103,209,155,4568.36,1.6,-3.30769,53.1196,6793.0
3535,2011,LL15 2,LL15 2,Total,3520,1753,1767,3516,4,80,14243.79,0.2,-3.32465,53.087,3523.0
3536,2011,LL16 3,LL16 3,Total,6694,3346,3348,6470,224,82,313.39,21.4,-3.41709,53.1851,6755.0
3537,2011,LL16 4,LL16 4,Total,4815,2353,2462,4683,132,90,9485.33,0.5,-3.38479,53.1837,5072.0
3538,2011,LL16 5,LL16 5,Total,4339,2241,2098,4287,52,101,18404.03,0.2,-3.49054,53.1871,4047.0
3539,2011,LL17 0,LL17 0,Total,5276,2567,2709,5110,166,91,4830.12,1.1,-3.43875,53.2554,5410.0
3540,2011,LL18 1,LL18 1,Total,3942,2086,1856,3933,9,20,95.57,41.2,-3.48949,53.3176,3936.0
3541,2011,LL18 2,LL18 2,Total,8472,4042,4430,8470,2,68,1318.9,6.4,-3.47685,53.3079,7916.0
3542,2011,LL18 3,LL18 3,Total,4661,2321,2340,4597,64,32,182.58,25.5,-3.47803,53.3243,4687.0
3543,2011,LL18 4,LL18 4,Total,10628,5138,5490,10628,0,117,424.38,25.0,-3.46829,53.3173,10741.0
3544,2011,LL18 5,LL18 5,Total,9760,4731,5029,9680,80,91,3718.83,2.6,-3.49977,53.2958,9761.0
3545,2011,LL18 6,LL18 6,Total,3089,1495,1594,3078,11,59,1123.1,2.8,-3.41173,53.3045,3428.0
3546,2011,LL19 7,LL19 7,Total,7107,3417,3690,7096,11,56,416.43,17.1,-3.42066,53.3355,7109.0
3547,2011,LL19 8,LL19 8,Total,7757,3694,4063,7741,16,61,774.63,10.0,-3.41444,53.3248,7336.0
3548,2011,LL19 9,LL19 9,Total,5060,2447,2613,5002,58,69,720.09,7.0,-3.39398,53.3334,5484.0
3549,2011,LL20 7,LL20 7,Total,4741,2382,2359,4664,77,42,13050.45,0.4,-3.15147,52.9491,4683.0
3550,2011,LL20 8,LL20 8,Total,3576,1781,1795,3482,94,37,4841.87,0.7,-3.17286,52.9728,3444.0
3551,2011,LL21 0,LL21 0,Total,2300,1173,1127,2292,8,39,13442.49,0.2,-3.43732,52.9702,2840.0
3552,2011,LL21 9,LL21 9,Total,3766,1891,1875,3718,48,59,21808.51,0.2,-3.38503,53.0055,3602.0
3553,2011,LL22 7,LL22 7,Total,8104,3829,4275,8007,97,73,496.12,16.3,-3.58099,53.2875,7887.0
3554,2011,LL22 8,LL22 8,Total,5448,2700,2748,5400,48,104,15149.57,0.4,-3.62997,53.2483,5639.0
3555,2011,LL22 9,LL22 9,Total,4148,1970,2178,4045,103,37,3236.08,1.3,-3.5432,53.2886,4364.0
3556,2011,LL23 7,LL23 7,Total,4362,2174,2188,4322,40,67,39263.53,0.1,-3.60258,52.9057,4136.0
3557,2011,LL24 0,LL24 0,Total,1939,1002,937,1876,63,33,27263.18,0.1,-3.78616,53.0586,2056.0
3558,2011,LL25 0,LL25 0,Total,474,240,234,474,0,4,5922.21,0.1,-3.87951,53.0545,501.0
3559,2011,LL26 0,LL26 0,Total,4577,2219,2358,4512,65,50,7961.6,0.6,-3.78694,53.1392,4528.0
3560,2011,LL27 0,LL27 0,Total,783,392,391,782,1,13,3689.58,0.2,-3.82715,53.1482,757.0
3561,2011,LL28 4,LL28 4,Total,8157,3697,4460,7763,394,119,327.74,24.9,-3.7461,53.3068,8310.0
3562,2011,LL28 5,LL28 5,Total,6000,2921,3079,5931,69,100,5677.98,1.1,-3.77291,53.27,5835.0
3563,2011,LL29 6,LL29 6,Total,1943,957,986,1943,0,44,66.85,29.1,-3.73366,53.2843,2166.0
3564,2011,LL29 7,LL29 7,Total,4397,2220,2177,4114,283,86,148.1,29.7,-3.7305,53.2941,4634.0
3565,2011,LL29 8,LL29 8,Total,6315,3095,3220,6116,199,83,808.15,7.8,-3.70317,53.2879,6613.0
3566,2011,LL29 9,LL29 9,Total,7672,3784,3888,7616,56,106,436.62,17.6,-3.69476,53.2899,7020.0
3567,2011,LL30 1,LL30 1,Total,9621,4478,5143,9342,279,88,511.55,18.8,-3.81901,53.3147,9803.0
3568,2011,LL30 2,LL30 2,Total,7386,3588,3798,6869,517,89,657.93,11.2,-3.83435,53.3221,7357.0
3569,2011,LL30 3,LL30 3,Total,4879,2314,2565,4840,39,74,421.71,11.6,-3.77994,53.3172,4850.0
3570,2011,LL31 9,LL31 9,Total,9473,4640,4833,9261,212,122,1144.7,8.3,-3.8109,53.2912,9344.0
3571,2011,LL32 8,LL32 8,Total,6518,3166,3352,6488,30,99,9667.69,0.7,-3.83993,53.2615,6502.0
3572,2011,LL33 0,LL33 0,Total,3877,1920,1957,3753,124,38,4762.27,0.8,-3.98368,53.2499,3906.0
3573,2011,LL34 6,LL34 6,Total,4353,2097,2256,4310,43,43,1526.81,2.9,-3.91332,53.2714,4347.0
3574,2011,LL35 0,LL35 0,Total,878,447,431,871,7,12,1128.22,0.8,-4.0408,52.5473,865.0
3575,2011,LL36 0,LL36 0,Total,1501,677,824,1446,55,15,151.75,9.9,-4.09536,52.5832,1312.0
3576,2011,LL36 9,LL36 9,Total,3174,1541,1633,3116,58,58,16793.64,0.2,-4.05656,52.6096,3348.0
3577,2011,LL37 2,LL37 2,Total,526,268,258,526,0,12,1206.94,0.4,-4.07045,52.671,554.0
3578,2011,LL38 2,LL38 2,Total,721,357,364,717,4,8,288.11,2.5,-4.03761,52.6989,724.0
3579,2011,LL39 1,LL39 1,Total,310,170,140,292,18,12,3488.2,0.1,-4.0007,52.7128,236.0
3580,2011,LL40 1,LL40 1,Total,2141,1038,1103,2058,83,39,3325.17,0.6,-3.89234,52.7405,2138.0
3581,2011,LL40 2,LL40 2,Total,1991,1003,988,1956,35,34,19770.14,0.1,-3.86104,52.7705,2072.0
3582,2011,LL41 3,LL41 3,Total,3004,1498,1506,2997,7,24,2864.14,1.0,-3.94328,52.9924,3076.0
3583,2011,LL41 4,LL41 4,Total,3475,1694,1781,3445,30,46,18706.18,0.2,-3.93343,52.9416,3396.0
3584,2011,LL42 1,LL42 1,Total,2522,1237,1285,2470,52,26,1600.34,1.6,-4.05572,52.726,2545.0
3585,2011,LL43 2,LL43 2,Total,467,219,248,458,9,3,372.52,1.3,-4.09237,52.7745,487.0
3586,2011,LL44 2,LL44 2,Total,1073,523,550,1057,16,13,4182.85,0.3,-4.09534,52.7874,1028.0
3587,2011,LL45 2,LL45 2,Total,645,316,329,632,13,12,5024.45,0.1,-4.09702,52.8201,708.0
3588,2011,LL46 2,LL46 2,Total,1900,938,962,1829,71,15,3259.39,0.6,-4.10774,52.8563,1856.0
3589,2011,LL47 6,LL47 6,Total,550,278,272,547,3,9,4396.12,0.1,-4.0625,52.902,537.0
3590,2011,LL48 6,LL48 6,Total,2587,1277,1310,2564,23,44,4132.79,0.6,-4.07115,52.9354,2603.0
3591,2011,LL49 9,LL49 9,Total,4651,2283,2368,4547,104,71,5290.03,0.9,-4.13832,52.9287,4502.0
3592,2011,LL51 9,LL51 9,Total,630,329,301,630,0,2,5490.71,0.1,-4.23711,52.9729,888.0
3593,2011,LL52 0,LL52 0,Total,2652,1253,1399,2583,69,42,2576.57,1.0,-4.2375,52.9248,2770.0
3594,2011,LL53 5,LL53 5,Total,4618,2296,2322,4578,40,70,1967.11,2.3,-4.42003,52.8886,4554.0
3595,2011,LL53 6,LL53 6,Total,5578,2698,2880,5561,17,72,10000.59,0.6,-4.4431,52.9293,5634.0
3596,2011,LL53 7,LL53 7,Total,3475,1729,1746,3451,24,75,7533.57,0.5,-4.50381,52.8415,3384.0
3597,2011,LL53 8,LL53 8,Total,3552,1798,1754,3552,0,61,13319.55,0.3,-4.59853,52.868,3570.0
3598,2011,LL54 5,LL54 5,Total,3267,1633,1634,3263,4,45,9767.45,0.3,-4.34917,53.0422,3088.0
3599,2011,LL54 6,LL54 6,Total,4135,1967,2168,4112,23,46,4276.26,1.0,-4.26484,53.0502,4238.0
3600,2011,LL54 7,LL54 7,Total,3840,1913,1927,3820,20,85,6577.65,0.6,-4.24917,53.0853,4054.0
3601,2011,LL55 1,LL55 1,Total,5170,2523,2647,5085,85,85,495.79,10.4,-4.25556,53.1457,5327.0
3602,2011,LL55 2,LL55 2,Total,6804,3308,3496,6752,52,80,1208.74,5.6,-4.2591,53.1358,6663.0
3603,2011,LL55 3,LL55 3,Total,3137,1549,1588,3123,14,37,3420.03,0.9,-4.14886,53.149,3099.0
3604,2011,LL55 4,LL55 4,Total,6582,3221,3361,6479,103,96,15988.86,0.4,-4.15575,53.1132,6355.0
3605,2011,LL56 4,LL56 4,Total,2284,1145,1139,2212,72,33,589.92,3.9,-4.20003,53.1877,2299.0
3606,2011,LL57 1,LL57 1,Total,6111,3000,3111,5737,374,49,192.08,31.8,-4.12375,53.2268,6022.0
3607,2011,LL57 2,LL57 2,Total,9872,4857,5015,7546,2326,203,616.16,16.0,-4.14306,53.2217,10018.0
3608,2011,LL57 3,LL57 3,Total,5624,2764,2860,5601,23,78,4997.92,1.1,-4.06385,53.1872,5617.0
3609,2011,LL57 4,LL57 4,Total,6076,3001,3075,6060,16,61,5600.06,1.1,-4.11927,53.1969,5931.0
3610,2011,LL58 8,LL58 8,Total,3858,1859,1999,3819,39,68,3402.39,1.1,-4.10086,53.2792,3883.0
3611,2011,LL59 5,LL59 5,Total,5630,2733,2897,5591,39,99,2662.79,2.1,-4.16115,53.2346,5611.0
3612,2011,LL60 6,LL60 6,Total,3149,1573,1576,3149,0,48,5429.1,0.6,-4.26795,53.2159,2817.0
3613,2011,LL61 5,LL61 5,Total,3107,1487,1620,2979,128,58,366.53,8.5,-4.20222,53.2238,3014.0
3614,2011,LL61 6,LL61 6,Total,2944,1430,1514,2891,53,34,4749.89,0.6,-4.29763,53.179,3321.0
3615,2011,LL62 5,LL62 5,Total,1704,823,881,1666,38,27,4088.48,0.4,-4.38605,53.2112,1694.0
3616,2011,LL63 5,LL63 5,Total,1370,682,688,1370,0,18,3923.64,0.3,-4.47063,53.2195,1339.0
3617,2011,LL64 5,LL64 5,Total,1008,489,519,992,16,16,241.82,4.2,-4.51479,53.2291,1001.0
3618,2011,LL65 1,LL65 1,Total,5358,2698,2660,5302,56,35,352.18,15.2,-4.63863,53.3113,5454.0
3619,2011,LL65 2,LL65 2,Total,8301,4058,4243,8223,78,66,3138.88,2.6,-4.62195,53.295,8205.0
3620,2011,LL65 3,LL65 3,Total,6525,3282,3243,6352,173,51,7524.94,0.9,-4.51658,53.2797,6436.0
3621,2011,LL65 4,LL65 4,Total,3490,1745,1745,3472,18,28,9213.6,0.4,-4.49682,53.3247,3470.0
3622,2011,LL67 0,LL67 0,Total,1357,672,685,1357,0,7,1372.64,1.0,-4.45636,53.4112,1416.0
3623,2011,LL68 0,LL68 0,Total,1293,641,652,1291,2,16,2352.31,0.5,-4.45546,53.3846,1276.0
3624,2011,LL68 9,LL68 9,Total,5092,2525,2567,5036,56,54,4854.35,1.0,-4.3478,53.4032,4839.0
3625,2011,LL69 9,LL69 9,Total,595,303,292,595,0,9,116.2,5.1,-4.31946,53.3862,735.0
3626,2011,LL70 9,LL70 9,Total,354,172,182,354,0,4,1323.71,0.3,-4.28801,53.3638,269.0
3627,2011,LL71 7,LL71 7,Total,227,111,116,223,4,0,1511.73,0.2,-4.399,53.3186,498.0
3628,2011,LL71 8,LL71 8,Total,1499,770,729,1499,0,16,2796.12,0.5,-4.35027,53.3324,1367.0
3629,2011,LL72 8,LL72 8,Total,710,334,376,710,0,10,66.74,10.6,-4.24576,53.3441,820.0
3630,2011,LL73 8,LL73 8,Total,254,127,127,254,0,9,1140.81,0.2,-4.24495,53.3352,233.0
3631,2011,LL74 8,LL74 8,Total,2236,1062,1174,2229,7,26,333.8,6.7,-4.23431,53.3149,2389.0
3632,2011,LL75 8,LL75 8,Total,1491,713,778,1429,62,22,1833.64,0.8,-4.22074,53.2836,1488.0
3633,2011,LL76 8,LL76 8,Total,324,173,151,316,8,6,476.33,0.7,-4.23934,53.3009,280.0
3634,2011,LL77 7,LL77 7,Total,7366,3558,3808,7333,33,102,7517.65,1.0,-4.31337,53.2596,6849.0
3635,2011,LL78 8,LL78 8,Total,509,254,255,509,0,19,333.84,1.5,-4.25957,53.3178,391.0
3636,2011,NP10 0,NP10 0,Total,1497,753,744,1497,0,29,77.29,19.4,-3.04673,51.5942,1704.0
3637,2011,NP10 8,NP10 8,Total,12113,5907,6206,12109,4,156,3884.9,3.1,-3.03659,51.5694,12117.0
3638,2011,NP10 9,NP10 9,Total,9591,4686,4905,9537,54,152,808.71,11.9,-3.05009,51.5899,9603.0
3639,2011,NP11 3,NP11 3,Total,4938,2452,2486,4900,38,43,565.3,8.7,-3.1523,51.6819,4805.0
3640,2011,NP11 4,NP11 4,Total,5779,2870,2909,5701,78,52,795.69,7.3,-3.14706,51.6634,5849.0
3641,2011,NP11 5,NP11 5,Total,6609,3297,3312,6578,31,42,1521.04,4.3,-3.13214,51.6668,6407.0
3642,2011,NP11 6,NP11 6,Total,11371,5539,5832,11364,7,80,739.07,15.4,-3.09399,51.6089,11141.0
3643,2011,NP11 7,NP11 7,Total,9099,4455,4644,8986,113,75,2922.23,3.1,-3.14496,51.6259,9244.0
3644,2011,NP12 0,NP12 0,Total,8020,3944,4076,7962,58,50,2046.89,3.9,-3.1893,51.6871,7959.0
3645,2011,NP12 1,NP12 1,Total,8496,4149,4347,8427,69,70,423.05,20.1,-3.19861,51.6683,8346.0
3646,2011,NP12 2,NP12 2,Total,8849,4375,4474,8790,59,60,594.81,14.9,-3.19145,51.6536,9296.0
3647,2011,NP12 3,NP12 3,Total,8159,3966,4193,8114,45,57,335.1,24.3,-3.21542,51.6668,8201.0
3648,2011,NP13 1,NP13 1,Total,8778,4307,4471,8688,90,51,1444.05,6.1,-3.13548,51.7356,8790.0
3649,2011,NP13 2,NP13 2,Total,6241,3146,3095,6241,0,40,1371.63,4.6,-3.13603,51.7128,6224.0
3650,2011,NP13 3,NP13 3,Total,4808,2395,2413,4781,27,33,794.26,6.1,-3.15773,51.765,5055.0
3651,2011,NP15 1,NP15 1,Total,5410,2875,2535,5007,403,131,8519.82,0.6,-2.89571,51.7033,6027.0
3652,2011,NP15 2,NP15 2,Total,2456,1213,1243,2374,82,45,5351.33,0.5,-2.87207,51.7714,2262.0
3653,2011,NP16 5,NP16 5,Total,11395,5500,5895,11269,126,169,510.23,22.3,-2.67559,51.6365,11322.0
3654,2011,NP16 6,NP16 6,Total,6907,3472,3435,6861,46,204,13158.78,0.5,-2.71994,51.662,6627.0
3655,2011,NP16 7,NP16 7,Total,5653,2793,2860,5386,267,90,2756.8,2.1,-2.66038,51.6519,5853.0
3656,2011,NP18 1,NP18 1,Total,4796,2306,2490,4688,108,129,2587.53,1.9,-2.95485,51.6152,4968.0
3657,2011,NP18 2,NP18 2,Total,6318,3122,3196,6260,58,86,5292.01,1.2,-2.91142,51.5901,6424.0
3658,2011,NP18 3,NP18 3,Total,6163,3002,3161,5506,657,141,541.39,11.4,-2.96634,51.6104,5889.0
3659,2011,NP19 0,NP19 0,Total,10862,5477,5385,10792,70,59,181.85,59.7,-2.97428,51.5836,10561.0
3660,2011,NP19 4,NP19 4,Total,4917,2387,2530,4917,0,35,309.83,15.9,-2.95152,51.576,5228.0
3661,2011,NP19 7,NP19 7,Total,12838,6343,6495,12831,7,116,280.55,45.8,-2.97512,51.5961,12772.0
3662,2011,NP19 8,NP19 8,Total,9322,4667,4655,9261,61,61,148.3,62.9,-2.97039,51.5884,9586.0
3663,2011,NP19 9,NP19 9,Total,13684,6499,7185,13621,63,79,355.84,38.5,-2.94232,51.5902,13509.0
3664,2011,NP20 1,NP20 1,Total,692,393,299,688,4,4,35.03,19.8,-2.99533,51.587,684.0
3665,2011,NP20 2,NP20 2,Total,7516,3802,3714,7470,46,68,554.87,13.5,-2.99115,51.5771,7620.0
3666,2011,NP20 3,NP20 3,Total,10983,5319,5664,10917,66,89,466.58,23.5,-3.01784,51.5769,10699.0
3667,2011,NP20 4,NP20 4,Total,6510,3273,3237,6268,242,81,148.93,43.7,-3.00302,51.5861,6486.0
3668,2011,NP20 5,NP20 5,Total,9485,4599,4886,9423,62,109,316.38,30.0,-3.00387,51.5948,9495.0
3669,2011,NP20 6,NP20 6,Total,7997,3850,4147,7925,72,66,207.1,38.6,-3.00597,51.6126,8097.0
3670,2011,NP20 7,NP20 7,Total,7606,3644,3962,7556,50,26,513.66,14.8,-3.02662,51.6093,7587.0
3671,2011,NP22 3,NP22 3,Total,7673,3741,3932,7577,96,54,980.23,7.8,-3.25211,51.7759,7610.0
3672,2011,NP22 4,NP22 4,Total,7430,3576,3854,7421,9,64,2187.33,3.4,-3.24295,51.7772,7593.0
3673,2011,NP22 5,NP22 5,Total,6921,3357,3564,6886,35,54,1915.18,3.6,-3.28148,51.7592,6855.0
3674,2011,NP23 4,NP23 4,Total,10165,5023,5142,10031,134,87,1316.97,7.7,-3.17409,51.7935,10042.0
3675,2011,NP23 5,NP23 5,Total,10748,5251,5497,10647,101,80,1164.83,9.2,-3.21211,51.7962,10584.0
3676,2011,NP23 6,NP23 6,Total,8419,4106,4313,8338,81,70,688.71,12.2,-3.20957,51.7757,8958.0
3677,2011,NP23 7,NP23 7,Total,2739,1356,1383,2734,5,23,725.26,3.8,-3.18206,51.7406,2735.0
3678,2011,NP23 8,NP23 8,Total,1434,722,712,1414,20,13,403.8,3.6,-3.1998,51.758,1066.0
3679,2011,NP24 6,NP24 6,Total,4966,2469,2497,4905,61,23,964.09,5.2,-3.2386,51.7214,4962.0
3680,2011,NP25 3,NP25 3,Total,5329,2597,2732,4998,331,144,2224.54,2.4,-2.70987,51.8152,5117.0
3681,2011,NP25 4,NP25 4,Total,3486,1742,1744,3391,95,87,7667.63,0.5,-2.72237,51.7731,3893.0
3682,2011,NP25 5,NP25 5,Total,6349,3059,3290,6233,116,131,6150.28,1.0,-2.73766,51.82,6434.0
3683,2011,NP26 3,NP26 3,Total,9305,4596,4709,9288,17,152,5141.32,1.8,-2.81303,51.5869,9416.0
3684,2011,NP26 4,NP26 4,Total,7669,3806,3863,7628,41,92,269.45,28.5,-2.75636,51.5922,7649.0
3685,2011,NP26 5,NP26 5,Total,5547,2762,2785,5505,42,85,2228.21,2.5,-2.74383,51.5942,5530.0
3686,2011,NP44 1,NP44 1,Total,8280,4070,4210,8244,36,70,368.77,22.5,-3.02622,51.6611,7853.0
3687,2011,NP44 2,NP44 2,Total,5440,2594,2846,5440,0,60,225.33,24.1,-3.00912,51.6602,5643.0
3688,2011,NP44 3,NP44 3,Total,7181,3486,3695,7047,134,50,842.9,8.5,-3.01953,51.6442,7060.0
3689,2011,NP44 4,NP44 4,Total,6680,3215,3465,6680,0,42,145.2,46.0,-3.04129,51.647,7155.0
3690,2011,NP44 5,NP44 5,Total,5788,2794,2994,5758,30,56,717.35,8.1,-3.04563,51.6582,5725.0
3691,2011,NP44 6,NP44 6,Total,5172,2549,2623,5096,76,84,255.11,20.3,-3.05651,51.6413,5382.0
3692,2011,NP44 7,NP44 7,Total,5273,2575,2698,5246,27,50,1107.05,4.8,-3.0322,51.6403,5194.0
3693,2011,NP44 8,NP44 8,Total,3361,1590,1771,3314,47,41,493.77,6.8,-3.00481,51.6468,3333.0
3694,2011,SA10 6,SA10 6,Total,9267,4508,4759,9114,153,66,1202.21,7.7,-3.84584,51.6563,9545.0
3695,2011,SA10 7,SA10 7,Total,10133,4914,5219,10050,83,113,1411.68,7.2,-3.82001,51.6713,9969.0
3696,2011,SA10 8,SA10 8,Total,6573,3214,3359,6566,7,87,3560.47,1.8,-3.77561,51.6972,6592.0
3697,2011,SA10 9,SA10 9,Total,3854,1909,1945,3800,54,18,2383.75,1.6,-3.69306,51.7729,3965.0
3698,2011,SA11 1,SA11 1,Total,6143,3082,3061,6103,40,42,151.28,40.6,-3.80431,51.6587,6180.0
3699,2011,SA11 2,SA11 2,Total,10046,4913,5133,10016,30,71,1064.74,9.4,-3.8171,51.6418,10006.0
3700,2011,SA11 3,SA11 3,Total,11479,5533,5946,11241,238,118,1337.85,8.6,-3.78872,51.661,11475.0
3701,2011,SA11 4,SA11 4,Total,3135,1552,1583,3135,0,19,2974.53,1.1,-3.70916,51.7046,3173.0
3702,2011,SA11 5,SA11 5,Total,5785,2865,2920,5748,37,45,4197.01,1.4,-3.62875,51.7453,5790.0
3703,2011,SA12 6,SA12 6,Total,10613,5174,5439,10499,114,68,295.72,35.9,-3.79996,51.5947,10552.0
3704,2011,SA12 7,SA12 7,Total,8459,4051,4408,8447,12,45,268.3,31.5,-3.81869,51.6032,8434.0
3705,2011,SA12 8,SA12 8,Total,6819,3305,3514,6769,50,65,901.86,7.6,-3.8011,51.6139,6937.0
3706,2011,SA12 9,SA12 9,Total,6767,3295,3472,6732,35,64,3003.86,2.3,-3.75724,51.623,6727.0
3707,2011,SA13 1,SA13 1,Total,5893,2925,2968,5829,64,42,135.79,43.4,-3.77958,51.5936,6042.0
3708,2011,SA13 2,SA13 2,Total,8487,4199,4288,8484,3,100,7033.71,1.2,-3.74955,51.5813,8193.0
3709,2011,SA13 3,SA13 3,Total,5283,2626,2657,5258,25,22,5595.5,0.9,-3.63452,51.6569,5282.0
3710,2011,SA14 6,SA14 6,Total,6834,3374,3460,6722,112,73,4327.54,1.6,-4.10349,51.7763,6442.0
3711,2011,SA14 7,SA14 7,Total,6239,3033,3206,6210,29,57,3426.08,1.8,-4.08815,51.8023,6221.0
3712,2011,SA14 8,SA14 8,Total,12891,6278,6613,12726,165,151,3103.22,4.2,-4.12174,51.6986,12803.0
3713,2011,SA14 9,SA14 9,Total,7999,3878,4121,7936,63,64,1015.85,7.9,-4.11516,51.6792,8251.0
3714,2011,SA15 1,SA15 1,Total,9615,4742,4873,9477,138,72,279.51,34.4,-4.15444,51.6796,9706.0
3715,2011,SA15 2,SA15 2,Total,8384,4124,4260,8342,42,66,472.53,17.7,-4.16109,51.6732,8096.0
3716,2011,SA15 3,SA15 3,Total,6993,3338,3655,6862,131,72,191.35,36.5,-4.1594,51.6863,7400.0
3717,2011,SA15 4,SA15 4,Total,5367,2608,2759,5289,78,56,1756.0,3.1,-4.18196,51.6933,5179.0
3718,2011,SA15 5,SA15 5,Total,6377,3158,3219,6371,6,78,4362.64,1.5,-4.18905,51.7624,6595.0
3719,2011,SA16 0,SA16 0,Total,8547,4164,4383,8508,39,63,4145.8,2.1,-4.25412,51.6891,8620.0
3720,2011,SA17 4,SA17 4,Total,6168,2991,3177,6144,24,51,3747.1,1.6,-4.26955,51.737,5828.0
3721,2011,SA17 5,SA17 5,Total,3239,1604,1635,3191,48,31,7651.71,0.4,-4.30119,51.7717,3148.0
3722,2011,SA18 1,SA18 1,Total,9580,4734,4846,9521,59,86,5608.99,1.7,-3.88921,51.7991,9129.0
3723,2011,SA18 2,SA18 2,Total,9000,4371,4629,8902,98,112,4469.88,2.0,-3.9714,51.7984,9698.0
3724,2011,SA18 3,SA18 3,Total,11107,5473,5634,10896,211,143,3883.69,2.9,-4.01181,51.7956,10916.0
3725,2011,SA19 6,SA19 6,Total,2971,1424,1547,2904,67,48,4748.5,0.6,-3.98564,51.8819,3209.0
3726,2011,SA19 7,SA19 7,Total,2686,1348,1338,2656,30,49,12100.45,0.2,-4.00325,51.9556,2903.0
3727,2011,SA19 8,SA19 8,Total,2206,1103,1103,2200,6,33,17509.25,0.1,-3.93797,52.0228,1936.0
3728,2011,SA19 9,SA19 9,Total,1531,771,760,1524,7,39,13815.98,0.1,-3.85529,51.9166,1614.0
3729,2011,SA20 0,SA20 0,Total,3574,1765,1809,3373,201,80,24469.01,0.1,-3.78837,52.0097,3515.0
3730,2011,SA31 1,SA31 1,Total,5748,2799,2949,5718,30,68,362.28,15.9,-4.30841,51.8596,5826.0
3731,2011,SA31 2,SA31 2,Total,3883,1858,2025,3854,29,83,1660.44,2.3,-4.29192,51.8566,4191.0
3732,2011,SA31 3,SA31 3,Total,7292,3340,3952,6688,604,89,1406.09,5.2,-4.32338,51.8535,7237.0
3733,2011,SA32 7,SA32 7,Total,4066,2028,2038,4045,21,79,21431.95,0.2,-4.18313,51.9194,3840.0
3734,2011,SA32 8,SA32 8,Total,3692,1807,1885,3673,19,81,9872.81,0.4,-4.15959,51.8486,3700.0
3735,2011,SA33 4,SA33 4,Total,5366,2616,2750,5275,91,95,9704.53,0.6,-4.49787,51.797,5595.0
3736,2011,SA33 5,SA33 5,Total,2920,1439,1481,2912,8,53,9056.87,0.3,-4.40394,51.8298,3302.0
3737,2011,SA33 6,SA33 6,Total,4060,2055,2005,4025,35,69,18849.61,0.2,-4.38983,51.9225,3710.0
3738,2011,SA34 0,SA34 0,Total,5398,2685,2713,5378,20,73,19910.43,0.3,-4.61836,51.8509,5019.0
3739,2011,SA35 0,SA35 0,Total,715,364,351,713,2,6,4247.69,0.2,-4.56095,51.9737,794.0
3740,2011,SA36 0,SA36 0,Total,395,210,185,395,0,6,676.22,0.6,-4.60869,51.9578,366.0
3741,2011,SA37 0,SA37 0,Total,1287,649,638,1284,3,18,4159.06,0.3,-4.59578,52.0177,1399.0
3742,2011,SA38 9,SA38 9,Total,4761,2310,2451,4681,80,51,10630.41,0.4,-4.4701,52.0415,4513.0
3743,2011,SA39 9,SA39 9,Total,2321,1168,1153,2298,23,26,6014.38,0.4,-4.24863,52.0206,2610.0
3744,2011,SA40 9,SA40 9,Total,3580,1748,1832,3482,98,31,10924.54,0.3,-4.16949,52.0852,3098.0
3745,2011,SA41 3,SA41 3,Total,1882,971,911,1882,0,39,9091.25,0.2,-4.70406,51.9982,1943.0
3746,2011,SA42 0,SA42 0,Total,2306,1100,1206,2290,16,40,5623.72,0.4,-4.85279,52.0156,2248.0
3747,2011,SA43 1,SA43 1,Total,4705,2264,2441,4667,38,59,3663.81,1.3,-4.64757,52.0922,4712.0
3748,2011,SA43 2,SA43 2,Total,5213,2579,2634,5207,6,72,6589.81,0.8,-4.58506,52.0882,5507.0
3749,2011,SA43 3,SA43 3,Total,2617,1257,1360,2574,43,40,5062.33,0.5,-4.68606,52.075,2677.0
3750,2011,SA44 4,SA44 4,Total,3862,1899,1963,3817,45,66,9420.48,0.4,-4.31756,52.0671,4031.0
3751,2011,SA44 5,SA44 5,Total,4959,2429,2530,4902,57,66,10335.22,0.5,-4.38902,52.0495,4733.0
3752,2011,SA44 6,SA44 6,Total,2669,1306,1363,2667,2,46,7685.84,0.3,-4.4161,52.1518,2657.0
3753,2011,SA45 9,SA45 9,Total,1730,861,869,1716,14,25,1544.36,1.1,-4.35809,52.2057,1642.0
3754,2011,SA46 0,SA46 0,Total,2732,1305,1427,2703,29,47,2709.58,1.0,-4.24514,52.2297,2666.0
3755,2011,SA47 0,SA47 0,Total,1250,648,602,1249,1,16,3294.15,0.4,-4.2967,52.1907,1136.0
3756,2011,SA48 7,SA48 7,Total,4556,2314,2242,4033,523,85,9056.03,0.5,-4.13424,52.1368,4760.0
3757,2011,SA48 8,SA48 8,Total,4395,2182,2213,4384,11,71,14270.56,0.3,-4.08775,52.1502,4465.0
3758,2011,SA61 1,SA61 1,Total,8041,3852,4189,8005,36,98,1041.54,7.7,-4.97581,51.7955,7934.0
3759,2011,SA61 2,SA61 2,Total,6221,2980,3241,6144,77,70,389.55,16.0,-4.97221,51.8042,6553.0
3760,2011,SA62 3,SA62 3,Total,5169,2483,2686,4994,175,98,11445.05,0.5,-5.08046,51.76,5286.0
3761,2011,SA62 4,SA62 4,Total,4481,2198,2283,4467,14,81,9526.63,0.5,-4.92778,51.7895,4295.0
3762,2011,SA62 5,SA62 5,Total,5626,2769,2857,5528,98,105,20243.27,0.3,-5.02223,51.9149,5547.0
3763,2011,SA62 6,SA62 6,Total,6056,3114,2942,5602,454,96,15847.74,0.4,-5.15916,51.8712,5768.0
3764,2011,SA63 4,SA63 4,Total,1112,556,556,1112,0,20,4774.13,0.2,-4.86204,51.8704,1263.0
3765,2011,SA64 0,SA64 0,Total,2462,1229,1233,2451,11,34,3960.72,0.6,-5.01075,52.002,2379.0
3766,2011,SA65 9,SA65 9,Total,4379,2095,2284,4298,81,54,6117.35,0.7,-4.97001,51.9884,4401.0
3767,2011,SA66 7,SA66 7,Total,3021,1469,1552,3016,5,66,10475.7,0.3,-4.74479,51.877,3200.0
3768,2011,SA67 7,SA67 7,Total,2316,1088,1228,2293,23,30,1717.98,1.3,-4.73452,51.8033,2298.0
3769,2011,SA67 8,SA67 8,Total,4614,2251,2363,4484,130,81,11770.22,0.4,-4.73321,51.7762,4640.0
3770,2011,SA68 0,SA68 0,Total,4305,2114,2191,4252,53,66,6116.49,0.7,-4.76439,51.731,4179.0
3771,2011,SA69 9,SA69 9,Total,3534,1755,1779,3447,87,59,915.63,3.9,-4.70675,51.7096,3707.0
3772,2011,SA70 7,SA70 7,Total,3225,1594,1631,3121,104,43,1481.79,2.2,-4.71836,51.6656,3407.0
3773,2011,SA70 8,SA70 8,Total,6506,3095,3411,6332,174,98,5583.26,1.2,-4.75489,51.6795,6116.0
3774,2011,SA71 4,SA71 4,Total,5636,2718,2918,5513,123,68,525.44,10.7,-4.91747,51.6769,5703.0
3775,2011,SA71 5,SA71 5,Total,4636,2285,2351,4626,10,83,11352.3,0.4,-4.94734,51.6629,4639.0
3776,2011,SA72 4,SA72 4,Total,828,409,419,828,0,16,1305.34,0.6,-4.89128,51.6954,787.0
3777,2011,SA72 6,SA72 6,Total,9753,4841,4912,9672,81,79,631.62,15.4,-4.94347,51.6915,9722.0
3778,2011,SA73 1,SA73 1,Total,8276,4000,4276,8214,62,104,3741.37,2.2,-4.97338,51.718,8426.0
3779,2011,SA73 2,SA73 2,Total,6832,3395,3437,6803,29,62,242.73,28.1,-5.03161,51.7162,6305.0
3780,2011,SA73 3,SA73 3,Total,5246,2515,2731,5244,2,59,1284.14,4.1,-5.04869,51.7171,5633.0
